Aartera	Aartera
Aasuan	Aasuan
abade*»	abade
abismo	abismo
abolição	abolicao
abraços	abraco
Abrigo	Abrigo
Abril	Abril
abril	abril
acabar	acabar
acaba	acabar
Academia	Academia
ações	acao
acção	acao
ação	acao
Acarape	Acarape
acaso	acaso
Ac<eile	Aceile
aceita	aceitar
aceitamos	aceitar
acelere	acelerar
acentuando	acentuar
acham	achar
ácido	acido
Acionistas	Acionistas
acompanhado	acompanhar
acompanhou	acompanhar
acompanha	acompanhar
acompanheis	acompanhar
Aconselhada	Aconselhada
aconselhado	aconselhar
Aconselho	Aconselho
acontecerá	acontecer
acontecer	acontecer
acontecimento	acontecimento
acredita	acreditar
acrescentando	acrescentar
acumulou	acumular
Adalloa	Adalloa
Adíodío	Adiodio
administração	administracao
Administração	Administracao
administrar	administrar
adversários	adversario
advertir	advertir
ADVOCACIA	Advocacia
ADVOGADO	Advogado
Advogado	Advogado
Afinei	Afinei
affinidade	afinidade
afirmação	afirmacao
afirmou	afirmar
afirmativa	afirmativa
agasalhar	agasalhar
agencia	agencia
AGÊNCIAS	Agencias
AgenclM	Agenclm
agentes	agente
agente	agente
Agincia	Agincia
Agostinho	Agostinho
agosto	agosto
Agosto	Agosto
agradecer	agradecer
agradecimentos	agradecimento
agricultor*»	agricultor
agrupamento	agrupamento
Agua	Agua
AguaA	Aguaa
Aguiar	Aguiar
Aguio	Aguio
Ahnl	Ahnl
1Ajncri«	Ajncri
Ajpr	Ajpr
alcance	alcance
Alcncarln»	Alcncarln
(AldeoU)	Aldeou
Aleacar	Aleacar
alega	alegar
Alegre	Alegre
Alencar	Alencar
Àlexínto	Alexinto
Alfaiataria	Alfaiataria
\Alfredo	Alfredo
alheios	alheio
aliado	aliado
Alíeres	Alieres
alimentação	alimentacao
allivio	alivio
almirante	almirante
Alnda	Alnda
Aloxs	Aloxs
Altaiakiria	Altaiakiria
alterar	alterar
altura	altura
aluno	aluno
Álvaro	Alvaro
ALVARO	Alvaro
alvura	alvura
ama	ama
amanhá	amanha
amantes	amante
Amariido	Amariido
Amarrado	Amarrado
Amatonla	Amatonla
Amazo-	Amazo-
Amazonas	Amazonas
ambiente	ambiente
Amcn	Amcn
Amcnc	Amcnc
Ameno	Ameno
America	America
América	America
Ameriça	America
americano	americano
Américo	Americo
amiga	amiga
Amigo	Amigo
amigos	amigo
amigo	amigo
AMÍRICA	Amirica
AMMM	Ammm
AMn»b	Amnb
«amo	amo
amos	amo
Amoroso	Amoroso
An-tonlo	An-Tonlo
anarchia	anarquia
ANCHIETA	Anchieta
Anchieto	Anchieto
Anchieu	Anchieu
andai	andar
andar	andar
ando	andar
andou	andar
ANDRADE	Andrade
anemia	anemia
ANNO	Anno
anos	ano
ANO	Ano
ano*	ano
ano	ano
anonymos	anonimos
antecedente	antecedente
Anti-CaUfrhaes	Anti-Caufrhaes
ANTOH	Antoh
anulaçóes	anulacao
annullar	anular
anuncia	anunciar
Aoui	Aoui
aparece	aparecer
aparelho	aparelho
apertar	apertar
apertado	apertar
aperte	apertar
apetite	apetite
^apitai	apitar
apoio	apoio
Approvadas	Approvadas
apreciador	apreciador
apreciado	apreciar
apreço	apreco
apresentar	apresentar
apresentou	apresentar
apresso	apresso
APRF-jnpT	Aprf-Jnpt
Aprovadas	Aprovadas
Aproveite	Aproveite
aproximo	aproximar
Archl	Archl
ardem	arder
arma	arma
(armação	armacao
armada	armada
armado	armar
Armazém	Armazem
aroma	aroma
Aront*	Aront
Arra-zonitíe	Arra-Zonitie
arte	arte
artigo	artigo
ARTILHEIROS	Artilheiros
artista	artista
ARTÍSTICOS	Artisticos
arvore	arvore
As-«ccuidoa**	As-Ccuidoa
As-odaçáo	As-Odacao
ASaiftAFUKAb	Asaiftafukab
aspectos	aspecto
Aspirantes	Aspirantes
assassinato	assassinato
Assembléia	Assembleia
assinados	assinado
assinalou	assinalar
assignantes	assinantes
assigno	assinar
Assis	Assis
assistirdes	assistir
associação	associacao
associar	associar
assunto*	assunto
atacante	atacante
Atado	Atado
“ATAL	Atal
atar	atar
atentado	atentado
atenue»	atenuar
aterrissaram	aterrissar
attestado	atestado
atestem	atestar
attesto	atesto
2ATHAR-Jy^	Athar-Jy
ATHAYDE	Athayde
«atilo	atilar
atinou	atinar
atingiu	atingir
atitudes	atitude
atividade	atividade
ativo	ativo
atleta	atleta
ATLETA	Atleta
ato	ato
atonia	atonia
•<A^tor*t	Atort
ATOS	Atos
Atrnd*	Atrnd
ATTESTAOOS	Attestaoos
Attesto	Attesto
atual	atual
atualmente	atualmente
atuai	atuar
Au-^red-sJo	Au-Red-Sjo
Audi»	Audi
Augusto	Augusto
aumentar	aumentar
aumento	aumento
Aürino	Aurino
AURINO	Aurino
Aurlno	Aurlno
Aurv’to	Aurvto
autarquia	autarquia
autentica	autentica
autêntico	autenticar
autos	auto
Autores	Autores
autoridades	autoridade
autoridade	autoridade
Autoriso-vós	Autoriso-Vos
Auxiliar”	Auxiliar
AUXILIAR	Auxiliar
auxiliar	auxiliar
avaliações	avaliacao
avarias	avaria
Avcmbléla	Avcmblela
aventuras	aventura
aventurara	aventurar
AVIAO	Aviao
avilo	avilar
Avisado	Avisado
Aviso	Aviso
AVISO	Aviso
aviso	aviso
Avmranir»-	Avmranir-
AXTICATAHIIES	Axticatahiies
azeite	azeite
B-P-b*	B-P-B
bacia	bacia
Bahia	Bahia
baia	baia
BAIANA	Baiana
baiano	baiano
Balivu	Balivu
BANCO	Banco
Banco	Banco
bande^	bandar
Bangu	Bangu
Barão	Barao
Barce-	Barce-
Barcellos	Barcellos
BARCELOS	Barcelos
Barcrllof	Barcrllof
Barctllos	Barctllos
Bardot	Bardot
Bareetlos	Bareetlos
barragem	barragem
base	base
básica	basica
bastando	bastar
Bastos	Bastos
bater	bater
beliscões	beliscao
beneficio	beneficio
Benfi-	Benfi-
Bererra	Bererra
BfmII	Bfmii
bichos	bicho
bilhões	bilhao
bilhão	bilhao
Blngú	Blngu
Bnr-wIoj	Bnr-Wioj
Bo>a-	Boa-
Bolato-	Bolato-
bolço	bolco
Bonsuccsso	Bonsuccsso
Bonsuccz-mente	Bonsuccz-Mente
Bonsuces-	Bonsuces-
BORDADOS	Bordados
Borgct	Borgct
Borges	Borges
Bot-afoso	Bot-Afoso
Botafogo	Botafogo
Botafoíto	Botafoito
BoUíodo	Bouiodo
BoUvkn»	Bouvkn
boxe	boxe
braços	braco
Branco	Branco
Brari)	Brari
(Brasil	Brasil
BRASIL	Brasil
Brasil	Brasil
brasileiras	brasileira
brasileira	brasileira
brasileiros	brasileiro
brasileiro	brasileiro
Brftj))	Brftj
Brigitte	Brigitte
brilho	brilho
brios	brio
Brookx	Brookx
Brssil	Brssil
Brunó	Bruno
Brwll	Brwll
Btinjtu	Btinjtu
Bunaunt	Bunaunt
C-nsWulíáo	C-Nswuliao
Ca’-o	Ca-O
Ca-piUJ	Ca-Piuj
Ca-sa	Ca-Sa
CABEÇA	Cabeca
cabeça	cabeca
Cabo	Cabo
Cabol	Cabol
cafés	cafe
café	cafe
caída*	caida
cair	cair
caixa	caixa
CAIXJUROS	Caixjuros
calçadas	calcada
calma	calma
calor	calor
camadas	camada
CAMBIO	Cambio
cambio	cambio
CAMPANHA	Campanha
campeão	campeao
CAMPEONATO	Campeonato
Campeonato	Campeonato
Campo	Campo
Campos	Campos
CAMPOS	Campos
Campou	Campou
cancelamentos	cancelamento
Câncer	Cancer
Cândido	Candido
(Canduijo	Canduijo
Cantara	Cantara
capai	capar
Capelo	Capelo
Capital	Capital
capital	capital
captura	captura
Car-	Car-
cara	cara
caras	cara
çarao	carao
Cardoso	Cardoso
carece	carecer
carecendo	carecer
cargo	cargo
cariocas	carioca
carioca	carioca
CARIOCA	Carioca
Carlos	Carlos
Carlri	Carlri
carpo	carpo
carta	carta
CARTAXO	Cartaxo
CARVALHO	Carvalho
Cas-Corvcla	Cas-Corvcla
casa	casa
casamento	casamento
casos	caso
Castro	Castro
CASTRO	Castro
cata	cata
catando	catar
causa	causa
causava	causar
cáustico	caustico
cautela	cautela
Cauuira	Cauuira
Cavalcante	Cavalcante
Cavalcnr	Cavalcnr
cavalheiros	cavalheiro
cavallo	cavalo
Ccnrenre	Ccnrenre
CcnUUn	Ccnuun
Cçsta	Ccsta
Cearense	Cearense
cearense	cearense
CEARENSE	Cearense
Cecrá	Cecra
“CEMA’	Cema
centraste	centrar
certame)	certame
chamo	chamar
chapa^	chapa
CHARÜÍO	Charuio
CHATEAUBRIAND	Chateaubriand
Chcgamns	Chcgamns
chefes	chefe
chefe	chefe
Chefes	Chefes
chegado	chegar
chegou	chegar
chegar	chegar
Chile	Chile
Chlrago	Chlrago
Chnfc	Chnfc
CHRONICA	Chronica
Churqlo	Churqlo
chuvas	chuva
ciar»	ciar
cidadão	cidadao
cidade	cidade
CidnditoCo*oncl	Cidnditocooncl
cientifico	cientificar
Cífncntoj	Cifncntoj
Ci>n»o>	Cino
circulo	circulo
Ciroí	Ciroi
Cirurgia	Cirurgia
CIRUROXAO	Ciruroxao
citado	citar
City	City
civil’	civil
civil	civil
Civil	Civil
clássico	classico
Cláudio	Claudio
clima	clima
CLINICA	Clinica
Clinica	Clinica
Cllnlc	Cllnlc
Clrurvia	Clrurvia
Clube	Clube
clube	clube
CLUBES	Clubes
Cnlou-	Cnlou-
Cnstovío	Cnstovio
C^nsuítorio	Cnsuitorio
Cochnne	Cochnne
Cochrana	Cochrana
Cochrane(	Cochrane
Codigo	Codigo
Codigu	Codigu
cofre	cofre
Cohaboração	Cohaboracao
coibir	coibir
Coixo	Coixo
Cojn	Cojn
Coleção	Colecao
COLÉGIO	Colegio
coletividade	coletividade
colhendo	colher
COLOCAÇAO	Colocacao
Coloniiaçáo	Coloniiacao
Colonização	Colonizacao
coluna	coluna
comarca	comarca
comarcas	comarca
combate	combate
combatendo	combater
Combatí	Combati
começo	comeco
Comercial	Comercial
COMERCIAL	Comercial
comerciai	comerciar
comerciais	comerciar
comercio	comercio
ComerçUd	Comercud
comecei	começar
Comíssáo	Comissao
Comíuão	Comiuao
companheiros	companheiro
COMPANHIA	Companhia
competia	competir
completado	completar
componha	compor
compunha	compor
Compos	Compos
compra	compra
comprei	comprar
compreenderá	compreender
compreensão	compreensao
Comprei	Comprei
Cômtedb	Comtedb
comunica	comunicar
comunidade	comunidade
••comunistas	comunista
comunista	comunista
Comuns	Comuns
Conaultorto-	Conaultorto-
concebe	conceber
conceber	conceber
Concederam	Concederam
conceito	conceito
(Conchijio	Conchijio
concluído	concluir
(Concluo	Concluo
concordatas	concordata
CONCURSO	Concurso
(Conda+Ao	Condaao
condições	condicao
(Conduiáo	Conduiao
conduta	conduta
conduzir	conduzir
conduziu	conduzir
conduziría	conduzir
Conferência	Conferencia
conferiu	conferir
confessar	confessar
confesso	confesso
confiança	confianca
confia	confiar
confidência*	confidencia
Confirmada	Confirmada
confirmam	confirmar
conhecido	conhecer
COnlca	Conlca
conquista	conquista
conquistou	conquistar
consciência	consciencia
Conselheiro	Conselheiro
conselho	conselho
Conselho	Conselho
conserto	conserto
conserva	conserva
considera	considerar
Consideravelmente	Consideravelmente
Consignações	Consignacoes
consisto	consistir
conspiração	conspiracao
constar	constar
constato	constatar
constatando	constatar
Constitui-	Constitui-
Constituição	Constituicao
Constltukâo	Constltukao
consulta	consulta
consulte	consultar
Consultório	Consultorio
Consultorio	Consultorio
CONTABILIDADE	Contabilidade
contacto	contacto
CONTADOR	Contador
Contavo	Contavo
contingência	contingencia
continuando	continuar
continuarem	continuar
continua	continuar
contos	conto
contrabando	contrabando
contradição	contradicao
contrario	contrario
Contratos	Contratos
controle	controle
convicção	conviccao
convidado	convidado
convidados	convidado
convidam	convidar
Convido	Convido
convier	convir
convim	convir
CONVOCAÇÃO	Convocacao
copo	copo
cor	cor
coração	coracao
cora	corar
Corno	Corno
coro	coro
côrôa	coroa
coronel	coronel
Coronel	Coronel
CORONEL	Coronel
corpo	corpo
corpos	corpo
Correia	Correia
CORREIA	Correia
CORREIAUÜ	Correiauu
CORREIO	Correio
correntes	corrente
corrente	corrente
corre	correr
corretas	corretar
corrupção	corrupcao
corta	cortar
CORTE	Corte
cortinas	cortina
COSTA	Costa
Costa	Costa
Costa—Pilulas	Costapilulas
CostaVenho	Costavenho
costumam	costumar
costumes	costume
COSTURA	Costura
cotejo	cotejo
Cottn	Cottn
Craa	Craa
crânio	cranio
Crará	Crara
Crbtov	Crbtov
Creado	Creado
Creadô	Creado
credenciado»	credenciar
credito	credito
crescente	crescente
crescimento	crescimento
cria	cria
criacão	criacao
Criado	Criado
CRIANÇAS	Criancas
criando	criar
criatura	criatura
crimes	crime
crime	crime
Criminal	Criminal
criminai)	criminar
Criminoso	Criminoso
criminosos	criminoso
criminoso	criminoso
cristã	crista
CristovSo	Cristovso
critério	criterio
critica	critica
criticas	critica
critico	critico
crônica	cronica
Cruroilo	Cruroilo
CRUSH	Crush
Crush	Crush
Cruto	Cruto
cruz	cruz
cruzeiros	cruzeiro
CRUZEIRO	Cruzeiro
Csla	Csla
CUagas	Cuagas
cuidai*	cuidar
culpa	culpa
culpado	culpar
cultivo	cultivo
Cumpre	Cumpre
cumprimento	cumprimento
cumpre	cumprir
cumprirá*	cumprir
Cunha	Cunha
CUNHA	Cunha
Cunrxo&s^Ce^re*	Cunrxoscere
Curado-	Curado-
curado	curar
cura*	curar
curiosidade	curiosidade
Curnn	Curnn
Curso	Curso
curso	curso
cursos	curso
CURSO	Curso
Cursou	Cursou
Curt	Curt
Curta	Curta
Curtis	Curtis
Curto	Curto
Custa	Custa
cúste	custar
custar	custar
CxWem-	Cxwem-
dados	dado
dado	dado
Dama	Dama
Dara‘0	Dara
Darcellas	Darcellas
data	data
DATILOCUFIA	Datilocufia
datilografia	datilografia
Dcponho	Dcponho
decidiu	decidir
décima	decima
DECIO	Decio
declarações	declaracao
declaração	declaracao
declarava	declarar
declara	declarar
declarar	declarar
decline	declinar
DECORAÇÕES	Decoracoes
decreto*	decreto
Deelarb	Deelarb
defesa	defesa
Defesas	Defesas
deixado	deixar
deixava	deixar
deixar	deixar
deixaria	deixar
deixasse	deixar
Delegado	Delegado
deliberação	deliberacao
deliberarem	deliberar
/delicio	deliciar
delicio	deliciar
delicto	delito
demonstrar	demonstrar
‘denota	denotar
denuncia	denuncia
Deoda-	Deoda-
Deodalo	Deodalo
Departamentos	Departamentos
departa	departir
Deparumm	Deparumm
depoimentos	depoimento
desarranjos	desarranjo
Desceram	Desceram
DESCEU	Desceu
descida	descida
descoberta	descoberta
desejado	desejar
desejo	desejo
Desembargador	Desembargador
desembargador	desembargador
desempenho	desempenho
desenvolver	desenvolver
desespero	desespero
designação	designacao
designado	designar
DESMENTINDO	Desmentindo
desmentiu	desmentir
desmentido	desmentir
desmoraliza	desmoralizar
Despachando	Despachando
despedida	despedida
despejos	despejo
despencar	despencar
Desporto»	Desporto
desprendimento	desprendimento
Dessi	Dessi
destino	destino
desvario	desvario
detalhes	detalhe
detrimento	detrimento
Deus	Deus
DeÜuxos	Deuuxos
devem	dever
deve	dever
devia	dever
devendo	dever
deveres	dever
deverá	dever
deveis	dever
deveríam	dever
dever	dever
devera	dever
Devo	Devo
devolucção	devolucao
Devporto»	Devporto
dezembro	dezembro
DEZEMBRO	Dezembro
dia*	dia
dia	dia
Diabete	Diabete
Diartos	Diartos
dicar	dicar
diferença	diferenca
diferenças	diferenca
diferente	diferente
dificuldades	dificuldade
dignidade	dignidade
DIHELAÜ	Dihelau
diligencias	diligencia
diminuição	diminuicao
dinheiro	dinheiro
direito	direito
Diretor	Diretor
Diretora	Diretora
Diretores	Diretores
Diretoria	Diretoria
dirigentes	dirigente
dirigir	dirigir
Dirvçío	Dirvcio
discado	discar
discriminação	discriminacao
DISCRIMINAÇÃO	Discriminacao
discurso	discurso
discutem	discutir
dispensa	dispensa
dyspepsia	dispepsia
dyspeptia	dispepsia
disponham	dispor
disposto	dispor
disposição	disposicao
disputa	disputa
disputado»	disputar
distribuir	distribuir
divulgado	divulgar
diga	dizer
digo	dizer
dizer	dizer
disse	dizer
dizia	dizer
Dizer-se	Dizer-Se
Dkrtratos	Dkrtratos
Dlogo	Dlogo
Dlrciot	Dlrciot
doei	doar
Doenças	Doencas
Domcado	Domcado
dominío	dominio
donas	dona
dono	dono
dor**	dor
dor{	dor
dores	dor
dor	dor
dOres	dor
Dôres	Dores
DORES	Dores
dorme	dormir
dose	dose
dotar	dotar
doutrinaria	doutrinar
«drink»	drink
duelo	duelo
DÜLAR	Dular
Dumas	Dumas
DUNI8TA	Dunita
dura	durar
duvida	duvida
duvidas	duvida
duvidando	duvidar
Dyspepsias	Dyspepsias
DYSPEPSIaS	Dyspepsias
Eatado	Eatado
Eaxnerino	Eaxnerino
economia	economia
Econômica	Economica
economico	economico
Edifício	Edificio
EDITAL	Edital
EDITORES	Editores
Edlticlo	Edlticlo
Edmar	Edmar
EDUARDO	Eduardo
Educação	Educacao
efetuará	efetuar
efficaz	eficaz
Efoy	Efoy
egípcios	egipcio
Eil-a	Eil-A
Eípcra-íe	Eipcra-Ie
EÍrnilian	Eirnilian
ELECTRIC	Electric
elegeram	eleger
elegeu	eleger
(eleição)	eleicao
elemento	elemento
elementos	elemento
Elétrica	Eletrica
elevado	elevado
elfo	elfo
Elíscos	Eliscos
ELIZEGUI	Elizegui
Ell-íicos	Ell-Iicos
Ell-tenx	Ell-Tenx
ELOY	Eloy
Eloy	Eloy
EMadas	Emadas
Emado	Emado
emmagrecímento	emagrecimento
embaixador	embaixador
embarques	embarque
Emdjano	Emdjano
Emi-liatio	Emi-Liatio
Emi-lihdorhandar	Emi-Lihdorhandar
Emigração	Emigracao
emigrantes	emigrante
Emiliano	Emiliano
Emiltano	Emiltano
empate	empate
empenho	empenho
empreender	empreender
empregados	empregado
empregado	empregado
empregar	empregar
emprego	emprego
empresta	emprestar
Emtlia-	Emtlia-
encarou	encarar
encarecer	encarecer
encargos	encargo
encomendou	encomendar
encontrasse	encontrar
encontraram	encontrar
encontrei	encontrar
encontra	encontrar
encontrado	encontrar
encontro	encontro
ENDKHKÇO	Endkhkco
enfermidade	enfermidade
enforcado	enforcar
engano	engano
Ennuanto	Ennuanto
ensino	ensino
Entea-do-mc	Entea-Do-Mc
entender	entender
entendimentos	entendimento
entidade	entidade
entrar	entrar
entregará	entregar
Entrevistas	Entrevistas
envenenado	envenenar
envolvam	envolver
enxerga	enxerga
época	epoca
equipo	equipar
equipe	equipe
equivocas	equivocar
era	era
Eraneúco	Eraneuco
Erbem	Erbem
errar	errar
erros	erro
erro	erro
esboço	esboco
escanchado	escanchar
escolhendo	escolher
escolhido	escolher
escravidão	escravidao
escrever	escrever
Escritas	Escritas
Escrito-rio	Escrito-Rio
escritor	escritor
esforços	esforco
esmagam	esmagar
esmolas	esmola
espaço	espaco
espantei	espantar
Especialidade	Especialidade
espera	espera
ESPERADO	Esperado
esperamos	esperar
Esperemos	Esperemos
espetáculo	espetaculo
espirito	espirito
esporte	esporte
Esporte	Esporte
esposa	esposa
esquecimento	esquecimento
Esta-duacs	Esta-Duacs
estabelecer	estabelecer
estabelecimentos	estabelecimento
Estado’	Estado
Estado	Estado
Estados	Estados
estou	estar
estiver	estar
esteja	estar
estavam	estar
estava	estar
estima	estima
ESTOMACAES	Estomacaes
Estomacaes	Estomacaes
estomago	estomago
ESTOMAOÕ	Estomaoo
Estorna-caes	Estorna-Caes
estrangeiro	estrangeirar
estreitam	estreitar
estudou	estudar
estudar	estudar
estudos	estudo
Estudos	Estudos
E<ther	Ether
europeus	europeu
evidencia	evidencia
exame	exame
exatamente	exatamente
exacto	exato
Exccul	Exccul
excellente	excelente
excursionou	excursionar
EXCURSIONARAM	Excursionaram
execução	execucao
executarem	executar
Executivo	Executivo
exercia	exercer
exercicio	exercicio
exercício	exercicio
Exercit	Exercit
exibem	exibir
exibe	exibir
exigido	exigir
exigiram	exigir
exige	exigir
exima	eximir
existência	existencia
existir	existir
existem	existir
Expansão	Expansao
experiência	experiencia
experimentava	experimentar
experimentar	experimentar
Experimente	Experimente
expor	expor
exportação	exportacao
exportadores	exportador
expressões	expressao
expresso	expressar
exterior	exterior
Extraordlnarla	Extraordlnarla
extrato	extrato
extravagante	extravagante
extrema	extremar
ExZè-só	Exze-So
faculdade	faculdade
Facundo—66	Facundo
FACUNDO	Facundo
Facundo	Facundo
fado	fado
fala	fala
fallar	falar
falava	falar
fallava	falar
falar	falar
FalcncUs	Falcncus
falecido	falecer
falta	falta
faltam	faltar
família	familia
fantástico	fantastico
fantásticos	fantastico
farão	farao
pharmaceutico	farmaceutico
faro	faro
fartura	fartura
fase	fase
facto	fato
fator»	fator
favores	favor
fazenda	fazenda
Fazenda	Fazenda
fazei	fazer
fizesse	fazer
fazer	fazer
fazerem	fazer
Fctreira	Fctreira
Fdifmo	Fdifmo
fé	fe
febre	febre
fechou	fechar
Fede-âo	Fede-Ao
Federação	Federacao
Federal	Federal
Feia	Feia
feira	feira
Feira	Feira
feitor	feitor
Feliçio	Felicio
Felizardo	Felizardo
feridas	ferida
FERNANDES	Fernandes
Ferreira	Ferreira
FERREIRA	Ferreira
FERRO	Ferro
Ferro	Ferro
fértil	fertil
Fhar-maceutico	Fhar-Maceutico
Fhtado	Fhtado
fiara	fiar
fiar	fiar
ficaram	ficar
ficando	ficar
ficarmos	ficar
ficaria	ficar
ficou	ficar
Filgucira	Filgucira
filhado	filhar
•filho	filho
filho	filho
Filho	Filho
filhos	filho
fim	fim
fins	fim
finalidade	finalidade
finanças	financas
fino	finar
finais	finar
firma	firma
firma*	firma
Firmas	Firmas
Fiscal	Fiscal
fiscalização	fiscalizacao
Fiuminente	Fiuminente
FJIOXIMOS	Fjioximos
flagelo	flagelo
Flamengo	Flamengo
FLORIANO	Floriano
Florianopolix	Florianopolix
floria	florir
Floriuno	Floriuno
Fltunúicnsc	Fltunuicnsc
Flumincnre	Flumincnre
Fluminense	Fluminense
fluçtuava	flutuar
fogo	fogo
folgo	folgar
fomento	fomento
Fonçs	Foncs
Fone-	Fone-
Fones	Fones
Fones-	Fones-
Fontoura	Fontoura
força	forca
forças	forca
forçada	forcada
formas	forma
forma	forma
formação	formacao
formalidade»	formalidade
Formosa	Formosa
formula	formula
formulas	formula
fornecer	fornecer
Fortal-	Fortal-
forte	forte
fortifica	fortificar
FortoUxo	Fortouxo
fosse	fossar
fóssil	fossil
foto	foto
foz	foz
Fran-íi	Fran-Ii
França	Franca
FRANCISCO	Francisco
Francisco	Francisco
fraqueza	fraqueza
fraternidade	fraternidade
Frcyrc	Frcyrc
FrMcba	Frmcba
Frot<	Frot
Frtc	Frtc
frui	fruir
Fstadoai	Fstadoai
FtfO	Ftfo
Fucab	Fucab
fuma	fumar
funcionários	funcionario
FUndade	Fundade
fundo	fundar
furador	furador
FURADOR	Furador
furador*	furador
furta	furtar
FUTEBOL	Futebol
Futebol	Futebol
futebol	futebol
futuro	futuro
FUvio	Fuvio
Fvrtulezu	Fvrtulezu
Fxüficio	Fxuficio
gabinete	gabinete
gado	gado
Ganhe	Ganhe
Garguta	Garguta
Gastrite	Gastrite
gato	gato
gaúcho	gaucho
Geauiindi	Geauiindi
General	General
genero	genero
gente	gente
Gentihndh	Gentihndh
Gentil	Gentil
geração	geracao
GERALDO	Geraldo
Gerente	Gerente
geriatria	geriatria
Gerson	Gerson
Gfrra]	Gfrra
Gilberto	Gilberto
GILDEMAR	Gildemar
Ginecologia	Ginecologia
Goal	Goal
GÓES	Goes
GoÍS^	Gois
gole	gole
GOLEADORES	Goleadores
Gomes	Gomes
Gonçalves	Goncalves
Gorgonto	Gorgonto
Gostaria	Gostaria
gosto	gosto
Governador	Governador
governador	governador
governante	governante
governava	governar
governa	governar
Governo	Governo
governo	governo
Governos	Governos
graças	graca
Graciàs	Gracias
g/^rais	gral
Gran	Gran
grão	grao
gratidão	gratidao
gratificação	gratificacao
Gratificação	Gratificacao
gratificações	gratificacao
gravai»	gravar
grave	grave
gravidade	gravidade
gregos	grego
Grorao	Grorao
Grrcnle	Grrcnle
GtnUludia	Gtnuludia
Guarda	Guarda
Gué-	Gue-
Guégué	Guegue
guerra	guerra
guias	guia
Guilherme	Guilherme
GURJÃO	Gurjao
hábitos	habito
Hade	Hade
Henrique	Henrique
hesitação	hesitacao
hesito	hesitar
Hi-Fi	Hi-Fi
higiene	higiene
Himina	Himina
hiperbole	hiperbole
historio	historiar
Hlolas	Hlolas
HOJí	Hoji
homens	homem
Homens	Homens
homicídio	homicidio
homicídio*^	homicidio
honestas	honestar
HONORIO	Honorio
Horaenj	Horaenj
horario	horario
horários	horario
Horário*	Horario
Horário	Horario
Horta	Horta
hospedagem	hospedagem
Hospital	Hospital
HoUl	Houl
humano	humanar
humana	humanar
humanas	humanar
humanai	humanar
humanidade	humanidade
Humberto	Humberto
Huromw	Huromw
Huviu	Huviu
Hygicoa	Hygicoa
Hygine	Hygine
Hygiuoo	Hygiuoo
IA(H)R	Iahr
IAPC	Iapc
íara	iara
Icadoa	Icadoa
Içgál	Icgal
idéias	ideia
idos	idos
Ifovta	Ifovta
IGOR	Igor
Igor	Igor
IIITICIÍÍ	Iiiticiii
IIJÀ	Iija
»\Ijus	Ijus
ilesos	ileso
Ilibada	Ilibada
ILLm	Illm
«Iludidas	Iludidas
Iluminai	Iluminai
imagens	imagem
Imagináveis	Imaginaveis
Imaneiro	Imaneiro
Imediato	Imediato
Imigrantes	Imigrantes
Imitamos	Imitamos
Imlxratorlo	Imlxratorlo
Império	Imperio
importaria	importar
impossibilidade	impossibilidade
Imposto	Imposto
imprensa	imprensa
IMPRENSA	Imprensa
ImpteesSo	Impteesso
Imputo	Imputo
Inaiuei-vels	Inaiuei-Vels
Incapazes	Incapazes
Incidem	Incidem
incommodos	incomodos
indicio	indicio
indicio»	indicio
índio	indio
Individual»	Individual
indivíduos	individuo
indivíduo	individuo
INDOLENTE	Indolente
indolentes	indolente
Indortrbl	Indortrbl
Industria	Industria
industria	industria
industrio	industriar
inefável	inefavel
Informaçáo	Informacao
informações	informacao
informarem	informar
informou	informar
InformuçÓM	Informucom
infortúnio	infortunio
infração	infracao
Ingrcasar	Ingrcasar
ingressos	ingresso
inicial	inicial
iniciando	iniciar
Iniciativa*	Iniciativa
inicio	inicio
Iniciou	Iniciou
Iníclizmcnte	Iniclizmcnte
inquérito	inquerito
Inrcrcvcr-ic	Inrcrcvcr-Ic
Inspecloria	Inspecloria
Inspfctor-	Inspfctor-
Inspiração	Inspiracao
Inspu-clorh	Inspu-Clorh
instauração	instauracao
instaurado	instaurar
Instituto	Instituto
Int-trucçôei	Int-Truccoei
intelectuais	intelectual
intelligencia	inteligencia
intelligente	inteligente
intensa	intensar
intenteis	intentar
intento	intento
interesses	interesse
intermédio	intermedio
Internas	Internas
intestinos	intestino
intima	intimar
Intransigente	Intransigente
Introduzida	Introduzida
intuito	intuito
Inulitufo	Inulitufo
inundo	inundar
InUríw	Inuriw
Invencibilidade	Invencibilidade
INVENCIBILIDADE	Invencibilidade
INVENTADAS	Inventadas
inventários	inventario
invernosa	invernoso
investimentos	investimento
Inveterado	Inveterado
INVICTOS	Invictos
Iodos	Iodos
Ipudo	Ipudo
ires	irar
IRMÃOS	Irmaos
Irns	Irns
irredutível	irredutivel
irregularidade	irregularidade
isenção	isencao
IVEIKA	Iveika
IXI<’-	Ixi-
J-irue	J-Irue
Jaburu	Jaburu
Jaguarlbe”	Jaguarlbe
Janari	Janari
Janebo	Janebo
janeiro	janeiro
Janeiro)	Janeiro
Janeiro	Janeiro
Janio	Janio
JANIO	Janio
Janlo	Janlo
Janto	Janto
japoneses	japonesar
JaUlon	Jaulon
Jcsé	Jcse
Jcurusribon*	Jcurusribon
J»femo	Jfemo
Jilhos	Jilhos
Jkvolvem	Jkvolvem
JNão	Jnao
Joaé	Joae
João	Joao
Joaquiiu	Joaquiiu
Joaquim	Joaquim
Jocclmo	Jocclmo
Joeo	Joeo
Jogador	Jogador
Jogai	Jogai
jogando	jogar
jogo	jogo
jogos	jogo
JOGOS	Jogos
Jogos	Jogos
JojZ	Jojz
Jo‘pcln	Jopcln
Joré	Jore
JORNAL	Jornal
jornal	jornal
Jornal	Jornal
Joró	Joro
JOSÉ	Jose
JOSE	Jose
José)	Jose
José	Jose
jovem	jovem
Jovem	Jovem
Jubó	Jubo
Juiz	Juiz
juizes	juiz
Julgados	Julgados
julgar	julgar
Julho	Julho
júnho	junho
junho	junho
Junho	Junho
juras	jurar
Jurv»	Jurv
Jusé	Juse
Justa	Justa
Justiça	Justica
justiça	justica
justo	justo
Juvenis	Juvenis
Kanvas	Kanvas
Kcpübllo»*	Kcpubllo
Kecommendo	Kecommendo
Kensngton	Kensngton
KGHAFICO	Kghafico
0<>KI<Kk	Kikk
Kmiliano	Kmiliano
Kopo	Kopo
Ktpcelalldade	Ktpcelalldade
Laboratórios	Laboratorios
laço	laco
lado	lado
Laís	Lais
LAKM»	Lakm
lambem	lambar
lançando	lancar
lando	lando
LAR	Lar
lato	latir
laudo	laudo
lavoura	lavoura
lavra	lavra
Layão	Layao
Leal	Leal
lebre	lebre
legalidade	legalidade
legião	legiao
legitimo	legitimar
Lei	Lei
lei	lei
Leio	Leio
leite	leite
lembraria	lembrar
lenho	lenho
Lerró	Lerro
leva	leva
levantado	levantar
levasse	levar
levar	levar
LIDA	Lida
(lideres	lider
liderança	lideranca
ligação	ligacao
Lima	Lima
LIMA	Lima
limítrofe*	limitrofe
limpeza	limpeza
língua	lingua
linha	linha
Lins	Lins
lios	lio
líricas	lirica
lirismo	lirismo
literatura	literatura
livros	livro
L*lghton	Llghton
local	local
localidade	localidade
loção	locao
locução	locucao
lodo	lodo
lógica	logica
LOJAS	Lojas
lona	lona
Londrts	Londrts
longa	longa
Lontcrno	Lontcrno
Lopei	Lopei
Lopes	Lopes
louco	louco
LUboo	Luboo
lucidez	lucidez
lucraria	lucrar
Lucros	Lucros
LUIS	Luis
Luiz	Luiz
luro	lurar
luta	luta
lutador	lutador
lutadores	lutador
luz	luz
Machado	Machado
macros	macro
maçro	macro
Madurcira	Madurcira
Madureira	Madureira
Madurelr»	Madurelr
magistrado	magistrado
MAGRO	Magro
maiores	maior
MAJOR	Major
Major	Major
malote»	malote
manda	manda
mandadas	mandada
mandado	mandado
mando	mando
Mandos	Mandos
manhã	manha
Manoel	Manoel
mansào	mansao
MANUEL	Manuel
manuscrito	manuscrito
mão	mao
MAO	Mao
mãos	mao
maquina	maquina
mar	mar
marcado	marcar
Marcelo	Marcelo
Marclllo	Marclllo
março	marco
mareando	marear
marginais	marginal
MARIA	Maria
Maria	Maria
MARINHA	Marinha
marinheiro	marinheiro
Marinho	Marinho
MÁRIO	Mario
Marmelada”	Marmelada
<marrou»	marrar
Martin	Martin
Martiniano	Martiniano
Martins	Martins
MarU	Maru
massas	massa
mata	mata
mate	mate
MATE	Mate
material	material
Mato	Mato
Matriculado)	Matriculado
máxima	maxima
máximo	maximo
Mcíkiroa	Mcikiroa
(Mcstrc-Geranl	Mcstrc-Geranl
meatos	meato
mecânico	mecanico
Medeiros	Medeiros
medicamentos	medicamento
medicamento	medicamento
Medicina	Medicina
medico	medico
MÉDICO	Medico
medida	medida
médio	medio
melo	melar
melhores	melhor
melhora	melhora
melhorar	melhorar
Mello	Mello
Melo	Melo
membro	membro
menção	mencao
mendicância	mendicancia
MENDICÂNCIA	Mendicancia
mendigos	mendigo
Mendonça	Mendonca
mengo	mengar
Mensais	Mensais
mente	mente
mentido	mentir
mentira	mentira
mentiroso	mentiroso
mento	mento
mentor	mentor
mera	mera
Mercy	Mercy
meridionais	meridional
méritos	merito
mezes	mes
meses	mes
mestre	mestre
metade	metade
métodos	metodo
MILITAR	Militar
militarismo	militarismo
mineira	mineira
mínima	minima
mínimo	minimo
Ministro	Ministro
ministro	ministro
minutos	minuto
mios	mio
mira	mira
mito	mito
Mnço	Mnco
mocidade	mocidade
moços	moco
Mod-cos	Mod-Cos
modernos	moderno
modismos	modismo
modos	modo
modo	modo
moles	mole
moléstias	molestia
MOLÉSTIAS	Molestias
momento	momento
momo	momo
Monguba	Monguba
montar	montar
Monte	Monte
moral	moral
morais	moral
Moreira	Moreira
morrer	morrer
morte	morte
morto	morto
Moruvla	Moruvla
mossa	mossa
mostre	mostrar
motos	moto
movimentos	movimento
movimento	movimento
Mqjece	Mqjece
Mrdkea	Mrdkea
Mtconlc	Mtconlc
mulher	mulher
mulheres	mulher
multas	multa
multo	multar
multidão	multidao
multidões	multidao
Municipal	Municipal
muno	munir
Murilo	Murilo
mutilado	mutilado
Na-í	Na-I
naçao	nacao
nação	nacao
nacional7	nacional
nacional	nacional
Nacional	Nacional
nara	nara
Narii	Narii
Nariz	Nariz
NASSER	Nasser
Ncsmx	Ncsmx
necessidade	necessidade
(Negociante	Negociante
Negociante	Negociante
negocio	negocio
negro	negro
neto	neto
NGER	Nger
«nica	nica
Nilo	Nilo
N0mtnftr	Nmtnftr
nobreza	nobreza
noite	noite
nomes	nome
Norberfo	Norberfo
NORDESTE	Nordeste
Nordeste	Nordeste
nordestinos	nordestino
nordestino	nordestino
NORhJ	Norhj
normal	normal
norte	norte
Norte	Norte
noto	noto
Novembro	Novembro
novidade	novidade
Novjmbro	Novjmbro
Npr-	Npr-
NrtA	Nrta
0NTFV	Ntfv
nume	nume
numero	numero
Nunoa	Nunoa
Nuvcmbro	Nuvcmbro
nuvem	nuvem
OAÇAU	Oacau
OAVID	Oavid
objetivo	objetivo
obras	obra
«óbre	obrar
obriga	obriga
obrigação	obrigacao
Obrigado	Obrigado
obrigado	obrigar
Obrm	Obrm
Obstetrícia	Obstetricia
OFFÍCIAES	Officiaes
oficial	oficial
Ol-rlo	Ol-Rlo
Olaria	Olaria
olhos	olho
Olhos	Olhos
Oliveira	Oliveira
Olnlz	Olnlz
OlUcicaj	Olucicaj
ombros	ombro
«omento	omento
Onafre	Onafre
Onça	Onca
OOOSOoO	Ooosooo
opinando	opinar
opinião	opiniao
Opiniões	Opinioes
opor	opor
Oportunidade	Oportunidade
oportunidade	oportunidade
Oraco	Oraco
Ordehado	Ordehado
ordem	ordem
Ordenado	Ordenado
Orfando	Orfando
organizou	organizar
organizando	organizar
OrgM	Orgm
originaes	originais
orlo	orlo
Osbnotivos	Osbnotivos
Ottonl	Ottonl
OUADROS	Ouadros
Ouadros	Ouadros
OUÇAM	Oucam
outorgado	outorgar
outubro	outubro
ouvido	ouvido
Ouvido»	Ouvido
OXtUltfMp	Oxtultfmp
P<-rü	P-Ru
Pacato	Pacato
Pacatuba	Pacatuba
Pacoty	Pacoty
padecem	padecer
padecer	padecer
pagam	pagar
pagar	pagar
Pagina)	Pagina
páginas	pagina
PAGINA	Pagina
pagina)	pagina
pagino)	paginar
país	pai
pai	pai
pais	pai
paióis	paiol
País	Pais
paiz	pais
paixões	paixao
Palacio	Palacio
Palacío	Palacio
palavras	palavra
pallidez	palidez
PALMEIRAS	Palmeiras
pane	pane
pântanos	pantano
parabéns	parabens
Paraíba*	Paraiba
PARALELO	Paralelo
paro	parar
parado	parar
parecer	parecer
parecia	parecer
parece	parecer
Parent*	Parent
Parente	Parente
paria	paria
parla	parlar
parque	parque
particular	particular
partida	partida
partidários	partidario
partidos	partido
PARTIDOS-	Partidos-
parta	partir
Partos	Partos
passada	passada
passageiros	passageiro
passagem	passagem
passou	passar
passasse	passar
passado	passar
passar	passar
passando	passar
passei	passar
passo	passo
pasta	pasta
Patente	Patente
patrocinou	patrocinar
patrulhas	patrulha
pau	pau
Paulet»	Paulet
paulistas	paulista
Paulista	Paulista
paulista	paulista
Paullno	Paullno
PAULO	Paulo
Paulo	Paulo
Paut	Paut
pauta	pauta
Pauto	Pauto
paz	paz
Pc-relra	Pc-Relra
33PCCIO3	Pccio
Pcihcirlo	Pcihcirlo
P‘dros=	Pdros
Pduardo	Pduardo
pé	pe
PeaquJu	Peaquju
peça	peca
PEÇAS	Pecas
peço	peco
Pedi	Pedi
Pediatria	Pediatria
pedidos	pedido
pedintes	pedinte
pedindo	pedir
Pedro	Pedro
“pega	pega
Peixoto	Peixoto
PEIXOTO	Peixoto
Pelé	Pele
Pele	Pele
Pelitardo	Pelitardo
pena	pena
penetra	penetrar
pensar	pensar
perda	perda
perdido	perdido
perdidos	perdido
perdido»	perdido
perfumaria	perfumaria
perfumes	perfume
pergunta	pergunta
período	periodo
permanecer	permanecer
permitindo	permitir
permitiu	permitir
pernas	perna
Pernambteco	Pernambteco
perseguir	perseguir
perseverar	perseverar
perturbação	perturbacao
peruo	peruar
pesado	pesar
pessoa	pessoa
PESSÒA	Pessoa
petas	petar
Pha^m-ceudco	Pham-Ceudco
Pharmaceutico	Pharmaceutico
PHARMACEUTICO	Pharmaceutico
PHARMACIA	Pharmacia
PHILIPS	Philips
Phparmaceutico	Phparmaceutico
pies	piar
Pihdas	Pihdas
PIihrmncculico	Piihrmncculico
pilai	pilar
pila	pilar
Pilhas	Pilhas
Pilim	Pilim
pilotado	pilotar
Pinbcirão	Pinbcirao
Pinheirão	Pinheirao
PINHEIRAO	Pinheirao
PINHEIRO	Pinheiro
Pinheirúo	Pinheiruo
Pinhtlrío	Pinhtlrio
pios	pio
pisasse	pisar
Pjrn»^	Pjrn
PKOXIMAS	Pkoximas
planos	plano
plano*	plano
planta	planta
plebiscitaria	plebiscitar
plebiscitos	plebiscito
PLENA	Plena
Pnulo	Pnulo
Poaso	Poaso
podo	podar
Podeis	Podeis
poder	poder
Poder/i	Poderi
poema	poema
policia	policia
polícia	policia
policial	policial
POLÍGONO	Poligono
Politica	Politica
política	politica
politica	politica
político	politico
políticos	politico
POLÍTICO	Politico
POLXLINICA	Polxlinica
Pompcu	Pompcu
Pompêo	Pompeo
ponderação	ponderacao
pontas	ponta
ponto»	ponto
ponto	ponto
pontos	ponto
PONTOS	Pontos
Populares	Populares
porções	porcao
pormenores	pormenor
Poro	Poro
PORTA	Porta
porta-voz	porta-voz
«portagem	portagem
Portaria	Portaria
Porte	Porte
Portela	Portela
Porto	Porto
PORTO	Porto
portos	porto
PORTUGUÊS	Portugues
possibilidade	possibilidade
Postal	Postal
postam	postar
postos	posto
povo	povo
PP-CHS	Pp-Chs
Ppharmaceutico	Ppharmaceutico
Pra-sidente	Pra-Sidente
praça)	praca
Praça	Praca
prática	pratica
prático	pratico
prazer	prazer
Prcsldcnie	Prcsldcnie
precisão	precisao
preciso	precisar
precisaria	precisar
precisando	precisar
Preclj4o	Precljo
preços	preco
preço	preco
preconceitos	preconceito
Preços	Precos
predomina	predominar
preenchimento	preenchimento
Prefiro	Prefiro
prego	prego
PRÉLIO5	Prelio
premo	premar
prêmio	premio
prenda	prenda
PREPARADAS	Preparadas
preparado	preparar
prepara	preparar
preparar	preparar
preparando	preparar
[preparam	preparar
presenciado	presenciar
presente	presente
Presidência	Presidencia
presidente	presidente
PRESIDENTE	Presidente
Presidente	Presidente
preso	preso
Press”	Press
Prestações	Prestacoes
prestando	prestar
pretender	pretender
prevalecem	prevalecer
prevalecer	prevalecer
PRÍIIO	Priiio
Primavera	Primavera
primeiros	primeiro
primo	primo
Princesa	Princesa
Príncipe	Principe
principio	principio
prisão	prisao
Prisão	Prisao
prisào	prisao
problema	problema
procedido	proceder
procedem	proceder
processos	processo
processo	processo
procura	procura
procurara	procurar
procurar	procurar
produto	produto
produzindo	produzir
produzimos	produzir
produsir	produzir
professamos	professar
Profissionais	Profissionais
profissional	profissional
profundidade	profundidade
profundo	profundo
progressos	progresso
ProJdRfcU	Projdrfcu
proletário	proletario
promotor	promotor
promoveu	promover
prompto	pronto
propaganda	propaganda
propiciar	propiciar
propinas*	propina
proporcionar	proporcionar
proposito	proposito
proposta	proposta
Propricdndr	Propricdndr
Propriedade	Propriedade
propriedade	propriedade
proprietário	proprietario
proprietários	proprietario
protejo	proteger
Prótese	Protese
provas	prova
prova	prova
provou	provar
providencias	providencia
providenciar	providenciar
província	provincia
Provincial	Provincial
prudência	prudencia
PrvMdcnte	Prvmdcnte
Psra	Psra
«Pt-lula^	Pt-Lula
Ptsrc	Ptsrc
publicação	publicacao
publicações	publicacao
publicas	publicar
publica	publicar
público	publico
publico	publico
PÚBLICO	Publico
Públio	Publio
PUBUUIDAÜt	Pubuuidaut
pula	pular
PULVOLAC	Pulvolac
punido	punir
Pur-gativaSi	Pur-Gativasi
PURGATIVAÍ	Purgativai
Purgativas	Purgativas
Purgativas»	Purgativas
PWTAM0	Pwtam
Quadr	Quadr
quadra	quadra
quadrai	quadrar
Quadres^	Quadres
quadro	quadro
Quadro	Quadro
Quadro»	Quadro
Quadros	Quadros
quartas	quarta
QUEBRAM	Quebram
Queira	Queira
queira	queira
Queremos	Queremos
Quero	Quero
”Quero	Quero
quilo	quilo
quilômetro	quilometro
química	quimica
quinze	quinze
quito	quitar
quites	quitar
QuixaJá	Quixaja
Quo-dro-	Quo-Dro-
quote	quotar
raças	raca
racial	raca
RACIAL	Racial
raciocínio	raciocinio
racionais	racional
radical	radical
radicais	radical
RÁDIOS	Radios
Radlo-teraph	Radlo-Teraph
Radlos	Radlos
raivar	raivar
RAíW	Raiw
raízes	raiz
RAMALHO	Ramalho
ramo	ramo
rápido	rapido
rápidos	rapido
(rata	rata
Ratas	Ratas
Raul	Raul
Razão	Razao
Rbdempção	Rbdempcao
Rcfídcncía	Rcfidcncia
Rcpmentante	Rcpmentante
reação	reacao
realizado»	realizar
realizado	realizar
Realmcnte	Realmcnte
rebanhos	rebanho
recado	recado
receberá	receber
receberam	receber
receber	receber
RECIFE	Recife
reclama	reclamar
recomende	recomendar
reconhecer	reconhecer
reconhecimento	reconhecimento
recorremos	recorrer
recorrí	recorrer
recuperando	recuperar
Recurso	Recurso
recursos	recurso
recurso	recurso
recusando	recusar
Redcm-pçâo	Redcm-Pcao
Redcmpção	Redcmpcao
rede»	rede
Redemp-çào	Redemp-Cao
redenção	redencao
Redompção	Redompcao
reduzir	reduzir
reduzindo	reduzir
reduz	reduzir
referido	referido
referiu	referir
Refirò-me	Refiro-Me
reforço	reforco
reforma	reforma
Reforma	Reforma
região	regiao
regime	regime
Registros	Registros
REGO	Rego
regressar	regressar
reis	rei
réis	rei
Reluiorío	Reluiorio
remedios	remedio
remédio	remedio
remedio	remedio
remo	remo
Renda)	Renda
rendo	rendar
Rendas	Rendas
rendeiro»	rendeiro
Rendimento	Rendimento
Repellida	Repellida
representa	representar
reproduz	reproduzir
Republca	Republca
Republica	Republica
republica	republica
REPUBLICA	Republica
RERNARfflNO	Rernarfflno
reserva	reserva
Residência	Residencia
residência	residencia
Residente	Residente
Residindo	Residindo
Residmon	Residmon
resíduos	residuo
resistência	resistencia
Resldcnda	Resldcnda
responder	responder
ressaltando	ressaltar
restabelecido	restabelecer
restantes	restante
resto	resto
resultados	resultado
resultado	resultado
resultando	resultar
resultar	resultar
recta	reta
RetíReaçáo	Retireacao
retorno	retorno
reunião	reuniao
reunirem	reunir
revelam	revelar
REVISTA	Revista
revolta	revolta
RFrA„D<00	Rfrad
RgaçJo	Rgacjo
rica	rica
rima	rima
Rio	Rio
(Rio	Rio
RIO	Rio
riscos	risco
Rlehard	Rlehard
Rloy	Rloy
Rlua	Rlua
RMervmtaa	Rmervmtaa
RMro	Rmro
Rnspltal	Rnspltal
Rocha	Rocha
RODADA	Rodada
rodada	rodada
RODADAS	Rodadas
róis	rol
ronda	ronda
rota	rota
Rou>jtíid	Roujtiid
Rrooke	Rrooke
Rrsidcncb	Rrsidcncb
RrUdrnte	Rrudrnte
Rstomacavs	Rstomacavs
RtbtlJtí	Rtbtljti
Rtera-rlo	Rtera-Rlo
ruas	rua
■ruas	rua
RubCT»	Rubct
RUBENS	Rubens
Ruiz	Ruiz
«rUm	rum
sabbados	sabado
sábado	sabado
saber	saber
sabia	sabia
Sabia	Sabia
Sabino	Sabino
S]ácidio	Sacidio
Saiate-Brure	Saiate-Brure
SAINDO	Saindo
SainUTropez	Sainutropez
saem	sair
saindo	sair
sahido	sair
Sala	Sala
Sala-303	Sala-
Salgado	Salgado
SALGADO	Salgado
Sallct	Sallct
Salloa	Salloa
Saltos	Saltos
Salvação	Salvacao
Sam-pjio	Sam-Pjio
Sampaio	Sampaio
Samtario	Samtario
sangria	sangria
sangue	sangue
Sanitário	Sanitario
Santa-	Santa-
Santana	Santana
SANTANA	Santana
Santlaco	Santlaco
Santos	Santos
sargento	sargento
Saulzinho	Saulzinho
SciHcb	Scihcb
Scmclham	Scmclham
Scnd	Scnd
Scr^do	Scrdo
Scveriano	Scveriano
Secrc-	Secrc-
secretaria	secretaria
secretario	secretario
Secretario	Secretario
segredos	segredo
segui	seguir
segurança	seguranca
seguros	seguro
seleção	selecao
selo	selo
Selo	Selo
semana	semana
semelhante	semelhante
SEMP	Semp
Sena	Sena
Senador	Senador
senhora	senhora
senhoras	senhora
SENHORAS	Senhoras
Senhoras	Senhoras
Senhoritos	Senhoritos
sensibilidade	sensibilidade
sentado	sentar
sentidos	sentido
sentia	sentir
sentindo	sentir
Seoho-ra»	Seoho-Ra
separação	separacao
separaçao	separacao
séquito	sequito
serão	serao
Seria	Seria
—Seria	Seria
seria	seriar
serio	serio
serra	serra
serviços	servico
serviço	servico
Serviço	Servico
SERVIÇOS	Servicos
Serviços	Servicos
servia	servir
servir	servir
servis	servir
setembro	setembro
SÍBÍFAGUERMue	Sibifaguermue
signatário	signatario
Silas	Silas
Simdo	Simdo
simples	simples
SINGER	Singer
singular	singular
sinistra	sinistra
síntese	sintese
Siqueira	Siqueira
sistema	sistema
Sistema	Sistema
situação	situacao
situar	situar
Si7va	Siva
Slfllh	Slfllh
Sllvt	Sllvt
Snnilariu	Snnilariu
soas	soar
Sobra)	Sobra
sôbra	sobra
SOBRAL	Sobral
Sobral	Sobral
SOBRALENSE	Sobralense
Sobretudo	Sobretudo
sobreTudò	sobretudo
sobro	sobro
socas	soca
Social	Social
social	social
sociedade	sociedade
sociedades	sociedade
sociologia	sociologia
Sofirendo	Sofirendo
—Sofrendo	Sofrendo
sofrido	sofrer
sofro	sofrer
sofria	sofrer
sofrendo	sofrer
sofrimentos	sofrimento
Sojto»c	Sojtoc
Sólidos	Solidos
solto	soltar
som	som
soma	soma
sombra	sombra
sorte	sorte
’«SSaaSxSS’	Ssaasxss
SsnMno	Ssnmno
SSS\SV^	Ssssv
STANDARD	Standard
suado	suadir
subindo	subir
subir	subir
subscrever	subscrever
subscripção	subscricao
subsistir	subsistir
substancia	substancia
substancio^»	substanciar
substitua	substituir
substituir	substituir
Substituto	Substituto
successo	sucesso
sucumbir	sucumbir
suicida	suicida
suicídio	suicidio
Suicídio	Suicidio
Sujos	Sujos
Sul	Sul
sul	sul
summario	sumario
Súo^Crbtovão	Suocrbtovao
supposto	suposto
Supremo	Supremo
surgir	surgir
surprêsa	surpresa
suscitado	suscitado
Suscitar	Suscitar
suspeitas	suspeita
sustentação	sustentacao
TAÇA	Taca
Taça	Taca
Tamb*m	Tambm
tamo	tamo
tango	tango
«tapa	tapa
tarde	tarde
tarefa	tarefa
tarifa	tarifa
TAVORA	Tavora
Távora	Tavora
taxa	taxa
Tcneate	Tcneate
teca	teca
técnica	tecnica
TELA	Tela
telegraphada	telegrafada
TELEGRAMA	Telegrama
TELES	Teles
televisão	televisao
Temos	Temos
TEMÓTEO	Temoteo
tempo	tempo
tempos	tempo
temporada	temporada
tendo	tender
Tendo	Tendo
Tendo-se	Tendo-Se
Tenente	Tenente
(Tenente	Tenente
Tenis	Tenis
tenis	tenis
tenistas	tenista
tentos	tento
teor	teor
terça-feira	terca-feira
TEREZA	Tereza
teria	teria
Terla	Terla
termina	terminar
termo	termo
termôs	termo
terra	terra
terras	terra
Terras	Terras
terreno	terreno
terrível	terrivel
testemunha	testemunha
testemunho	testemunho
THBODORICO	Thbodorico
Theophilo	Theophilo
tiça	ticar
tílias	tilia
tingido	tingir
tinha	tinha
“Tinir	Tinir
tio	tio
tipo	tipo
tirada	tirada
tirando	tirar
tire	tirar
titulo	titulo
título	titulo
T*ntnt*	Tntnt
TntrtnaigtQte’*	Tntrtnaigtqte
toço	toco
Toe-m	Toe-M
tolos	tolo
Tomando	Tomando
tomei	tomar
tomou	tomar
tomasse	tomar
tomado	tomar
tome	tomar
tomava	tomar
tomar	tomar
tomando	tomar
tonas	tona
TondO	Tondo
tonto	tonto
Tony	Tony
Tora	Tora
Torneio	Torneio
TORNEIO	Torneio
Torrei	Torrei
Torres	Torres
Tosus	Tosus
‘Tou^ijLçgo	Touijlcgo
trabalhou	trabalhar
trabalho	trabalho
traduziu	traduzir
Traente	Traente
Traga	Traga
Tranle	Tranle
tranquilidade	tranquilidade
transferiu	transferir
transformaria	transformar
transporte	transporte
(tratamento	tratamento
tratamento	tratamento
TRATAMKNTO	Tratamknto
tratando	tratar
trata	tratar
tratar	tratar
tratei	tratar
trato	trato
travará	travar
travara	travar
Trciniimento	Trciniimento
tremendas	tremenda
t^ria	triar
Tribunal	Tribunal
tricolor	tricolor
TrincíM	Trincim
tripulantes	tripulante
tristes	triste
triste	triste
Triunfo	Triunfo
trocar	trocar
troyanos	troianos
tronco	tronco
Trutáo	Trutao
TteHx	Ttehx
Tuberculoses	Tuberculoses
tU(Jo	tugir
tuna	tuna
Tuolros	Tuolros
Tutu	Tutu
Üangu	Uangu
UATEGOKIAS	Uategokias
UDlfo	Udlfo
UKRKMJtA	Ukrkmjta
Ulíh%	Ulih
ultima	ultimar
ultimas	ultimas
ultimo	ultimo
último*	ultimo
umidade	umidade
Umpos	Umpos
Unha	Unha
unidade	unidade
Unido*	Unido
Unidos	Unidos
unis	unir
Unitapio	Unitapio
Unitário	Unitario
UNITÁRIO	Unitario
untes	untar
Urcel	Urcel
urgência	urgencia
Urina	Urina
Uror	Uror
urra	urrar
Urti	Urti
usar	usar
Usina	Usina
Uvai	Uvai
UX1TARIQ	Uxtariq
Uzando	Uzando
VA-A’	Va-A
Vadax	Vadax
valente	valente
valia	valia
valo	valo
valor	valor
Vana-diol	Vana-Diol
Vanadiol	Vanadiol
VANADIOL	Vanadiol
vantagem	vantagem
Vapores	Vapores
VARGAS	Vargas
Vasco	Vasco
Vav#r*	Vavr
%VAWaSSV	Vawassv
veias	veia
velha	velha
velhice)	velhice
vencer	vencer
vendem	vendar
Vendas	Vendas
vender	vender
venderá	vender
Venho	Venho
ventos	vento
ventre	ventre
verbo	verbo
verdade	verdade
verdadeiro	verdadeiro
vesperas	vespera
vestigios	vestigio
Veua	Veua
vez	vez
vezos	vezo
VFNANCÍO	Vfnancio
viajando	viajar
Viana	Viana
vidas	vida
VIDA	Vida
vida	vida
VifOll*	Vifoll
vigor	vigor
vinha	vinha
vinho	vinho
violento	violentar
violeta	violeta
VI<Or“r	Viorr
viram	virar
Virgílio	Virgilio
virtude	virtude
VIRTUDE	Virtude
VISÃO	Visao
visibilidade	visibilidade
visite	visitar
visitei	visitar
vista	vista
visto	visto
Vital	Vital
vítimas	vitima
victima	vitima
Vítor	Vitor
vitoria	vitoria
vitória	vitoria
vivia	viver
vivo	vivo
Vn-da	Vn-Da
Vnido%	Vnido
Vodka	Vodka
VODKA	Vodka
Voltar	Voltar
voltas	voltar
volta	voltar
voluntário	voluntario
vontade	vontade
VõscO	Vosco
voto	voto
VOZ	Voz
Vugu*t*	Vugut
vulto	vulto
Waldcmar	Waldcmar
Walter	Walter
WALTER	Walter
Whitakcr	Whitakcr
WIUVJ	Wiuvj
“Worthinglon*	Worthinglon
WOTGAR	Wotgar
WPRINCIPE	Wprincipe
Wtalube	Wtalube
WZWWW	Wzwww
X-JLJI	X-Jlji
Xinhas	Xinhas
XLOI-JH	Xloi-Jh
XM-O	Xm-O
Zelo	Zelo
