----	----
-----	-----
------	------
-------	-------
---------	---------
-------------—	-------------
---------------	---------------
----------------	----------------
-------------------1	-------------------
4-----------------------	-----------------------
------------------------	------------------------
---------------------------------	---------------------------------
------“I	------i
---V	---v
-AG1NA	-agna
-associada	-associada
-AVVVWWVÍS^	-avvvwwvis
-cce	-cce
-corrido	-corrido
-Criró	-criro
-das	-das
-dutor	-dutor
-EEIRA	-eeira
-Exf-«per	-exf-per
-FEIRA	-feira
42-57—Horario	-horario
-ido	-ido
-«IhEIIU	-iheiiu
-i*plra0ea	-iplraea
(<-lTcn	-ltcn
-ma-Ç0CB	-ma-ccb
-mas	-mas
-mister	-mister
-nfA»	-nfa
-•OHor	-ohor
-oren	-oren
-*rrv>»Ho	-rrvho
-satisfncto-ctorio	-satisfncto-ctorio
-torurwb	-torurwb
-vicção	-viccao
-zador	-zador
aa-üslencla	aa-uslencla
aahio	aahio
aáno	aano
aasumptoà	aasumptoa
absolutamentc	absolutamentc
absolutamente	absolutamente
absoluto	absoluto
acceiio	acceiio
acceileis	acceileis
accníuada	accniuada
accu-np	accu-np
acha-sc	acha-sc
acha-se	acha-se
acha-ze	acha-ze
achando-me	achando-me
achar-se	achar-se
achfido	achfido
acicncia	acicncia
acomoanheis	acomoanheis
acomodou-se	acomodou-se
aconteça	aconteca
acredita-t	acredita-t
acreicenlar	acreicenlar
actc	actc
acto	acto
(acto	acto
actos	actos
acusu-çòts	acusu-cots
acuuçOes	acuucoes
ad-mittida	ad-mittida
adjacentes	adjacentes
adrades	adrades
aeíma	aeima
aeoKfe-	aeokfe-
aeritoú	aeritou
afíccJonados	aficcjonados
afírria	afirria
agi-tão	agi-tao
agra-deccr-lhe	agra-deccr-lhe
agrade-cicnantos	agrade-cicnantos
aguar-	aguar-
aguarendo	aguarendo
ahstrataj	ahstrataj
aiBumptos	aibumptos
aicaute	aicaute
aicel	aicel
aífirma	aifirma
aíim	aiim
aimpn-	aimpn-
aintte	aintte
aítl-(M	aitl-m
aituaçlo	aituaclo
âiwio	aiwio
alcançando	alcancando
alcançar	alcancar
aleacarioa	aleacarioa
alecatlra	alecatlra
alliviado	alliviado
allz«ção	allzcao
al£uns	aluns
ama-	ama-
amaahí	amaahi
amarrai-o	amarrai-o
ameaçava	ameacava
am»go<	amgo
aMistcncíil	amistcnciil
ãmparciHimente	amparcihimente
ampard	ampard
analphabetos	analphabetos
anaütar	anautar
anbreviva-r*m	anbreviva-rm
andarão	andarao
anêmicas	anemicas
aníe-ontem	anie-ontem
anjiu	anjiu
annc	annc
annó	anno
annos	annos
annual	annual
annuncio	annuncio
anoa)	anoa
antccroa-va	antccroa-va
antex	antex
antigamente	antigamente
anuilmenle	anuilmenle
anunciada	anunciada
aoenas	aoenas
aojào	aojao
aolTrem	aoltrem
aoocui	aoocui
aorr-ciauecimcnto	aorr-ciauecimcnto
aoui	aoui
apare-	apare-
apenaa	apenaa
apfnar	apfnar
appro*	appro
apreça*	apreca
aprehender	aprehender
apreren	apreren
apresentada	apresentada
apróço	aproco
aquetag	aquetag
argumentx	argumentx
ario	ario
ariüto	ariuto
árldaa	arldaa
armados	armados
arrel^ta-wi	arrelta-wi
arrúmem-se	arrumem-se
artifdais	artifdais
artig)	artig
artig	artig
artirmativa	artirmativa
5artn	artn
asccnçõo	asccncoo
asii	asii
assegurar-lhe	assegurar-lhe
assenta	assenta
assignadas	assignadas
assun	assun
assustadoura	assustadoura
a’sunt0	asunt
átecandrate	atecandrate
atendendo	atendendo
atfirmar	atfirmar
athrmou	athrmou
at<ifuturai	atifuturai
atiypóihtse	atiypoihtse
atrazadas	atrazadas
attençno	attencno
attestadot}	attestadot
atteu-çào	atteu-cao
attos-tados	attos-tados
attum	attum
atualmantc	atualmantc
aubtdo	aubtdo
augmentavam	augmentavam
aUiW*lixado	auiwlixado
aumen	aumen
auminlo	auminlo
àutae	autae
avláo	avlao
avmen-	avmen-
axaiam«nte	axaiamnte
axtlnt*	axtlnt
ba-»e	ba-e
ba-r	ba-r
bacilb	bacilb
bacterícas	bactericas
bagí	bagi
baír	bair
baseadas	baseadas
bCiios	bciios
bem-	bem-
bemditas	bemditas
bem*no	bemno
benefica	benefica
benéfico	benefico
beneflclo*	beneflclo
bisU»sem	bisusem
blAKIOM	blakiom
bmllelro	bmllelro
braalieifo	braalieifo
branco”	branco
brancos	brancos
braneo	braneo
bre-v*	bre-v
bronchilo	bronchilo
buom	buom
bxsrs	bxsrs
ca-valro	ca-valro
caao	caao
cacias	cacias
cadei-	cadei-
cadu	cadu
cafeeiro	cafeeiro
cafeoi»	cafeoi
cafezinho	cafezinho
caixinha	caixinha
cam-	cam-
cambto	cambto
campconal	campconal
campeo-I*	campeo-i
campróo	camproo
capacidade—a	capacidadea
capazes	capazes
capita)	capita
caraclcrisado	caraclcrisado
carloctr	carloctr
carluz	carluz
cavall	cavall
cbrintoriedade	cbrintoriedade
cbügaria	cbugaria
ccaren	ccaren
cccn	cccn
(cçío	ccio
çcla	ccla
ccnjectu-ras	ccnjectu-ras
ccnsideração	ccnsideracao
cçôos	ccoos
ccqvaiilo	ccqvaiilo
ccrração	ccrracao
ccrtam»	ccrtam
cddiii	cddiii
cegos	cegos
ceríame	ceriame
cert_	cert
certam--	certam--
ce*tr«s	cetrs
cffeiio	cffeiio
cffeito	cffeito
cfficaciu	cfficaciu
cfieito	cfieito
çfio	cfio
chamnr	chamnr
chi-méras	chi-meras
chuv*j	chuvj
ciaa«eê	ciaaee
cieuridáo	cieuridao
cila	cila
Çional	cional
circumalandas	circumalandas
cíti<->	citi-
cíuxru	ciuxru
civilisado	civilisado
cIvm	civm
civteoi	civteoi
cjvo	cjvo
cknsd*	cknsd
clawo	clawo
clirfaJo	clirfajo
clTê	clte
clubrs	clubrs
clvmo	clvmo
cmpraltarn	cmpraltarn
c^mprKMe	cmprkme
cn»aíOT	cnaiot
çncola	cncola
cncon-trar-sc	cncon-trar-sc
•c^n^crrndoYtvs	cncrrndoytvs
çnhprnr	cnhprnr
cnjelmcntj	cnjelmcntj
cnlrcsue	cnlrcsue
cnmpu-zerem	cnmpu-zerem
cnnrhdnto-	cnnrhdnto-
cntcndimcDk*	cntcndimcdk
cntrevijix	cntrevijix
cnusii	cnusii
co-nhecjdis	co-nhecjdis
co-preservação	co-preservacao
coafiar	coafiar
coafrt	coafrt
cociri	cociri
coiiulia	coiiulia
coisos	coisos
coI<xt	coixt
coleti-vidade	coleti-vidade
collaboradores	collaboradores
coltçáo	coltcao
combale	combale
começa	comeca
começou	comecou
comMgo	commgo
comnttes-oni	comnttes-oni
comolctc	comolctc
compiT^/	compit
completame	completame
completamea-te	completamea-te
completamente	completamente
compromirjor	compromirjor
compromlrjor	compromlrjor
con-/	con-
con-	con-
con-du/ir	con-duir
con-fere	con-fere
con-trarit)	con-trarit
conaeoucncio5	conaeoucncio
conbreiJoa	conbreijoa
concedida	concedida
concidadãos	concidadaos
concluil-a	concluil-a
concrói-r	concroi-r
concrxpv	concrxpv
condida	condida
condt-çõei	condt-coei
conform»	conform
conh	conh
conícrencla	conicrencla
conllnjcnte	conllnjcnte
conMHuIu	conmhuiu
conqulrtu	conqulrtu
consequente	consequente
consequente-	consequente-
consequentemente	consequentemente
considerável	consideravel
considertt	considertt
considoraçõ	considoraco
considorci-me	considorci-me
consjatação	consjatacao
conslderá-lo	consldera-lo
constante	constante
constantes	constantes
constltu*	constltu
consultadoa	consultadoa
consultavão	consultavao
continuarão	continuarao
controvéraliu	controveraliu
convem	convem
conveui-	conveui-
convircão	convircao
convo-slí^í^mJt0	convo-sliimjt
convulsos	convulsos
cooacguir	cooacguir
coopeonoto	coopeonoto
coQsuha	coqsuha
corbiTíf^Wborato	corbitifwborato
corocccUa	corocccua
corpo-	corpo-
corrent-	corrent-
correspondeneia	correspondeneia
corua	corua
coslonhos	coslonhos
costanhas	costanhas
cota-	cota-
cotncar	cotncar
co|ul	coul
cquilíbri	cquilibri
*™craÇ-10	crac-
crande	crande
crandes	crandes
crapalpntc»	crapalpntc
creore	creore
creou	creou
cri-rr	cri-rr
criador	criador
crimí-	crimi-
criminô-	crimino-
criminoao	criminoao
crits*“V	critsv
cróu	crou
cruel	cruel
cruidlros	cruidlros
cruzri	cruzri
crwtcirot	crwtcirot
cscandalo	cscandalo
csdíritual	csdiritual
csíar	csiar
csnceífi-ca	csnceifi-ca
ç^stas	cstas
cstoma-hín	cstoma-hin
cstomr	cstomr
cstraneclroí	cstraneclroi
ct»fé	ctfe
ctiioU	ctiiou
c^tnrvoo	ctnrvoo
ctoborar	ctoborar
ctoema	ctoema
c*tregue	ctregue
cttnaG	cttnag
ctujiv*	ctujiv
cu-ar^o	cu-aro
cu-|rad	cu-rad
cuiaado	cuiaado
cuidadosjsem	cuidadosjsem
cuio	cuio
cum-tudo	cum-tudo
cumplelamente	cumplelamente
cural-aa	cural-aa
cUrnl-raçf»o	curnl-racfo
cust»	cust
cuUvm	cuuvm
cwas	cwas
cx-Rio-	cx-rio-
cxigcncias	cxigcncias
cxsas	cxsas
cxtcncial	cxtcncial
czpedida	czpedida
d-ccnda	d-ccnda
d-rorl	d-rorl
dada	dada
daqu	daqu
dar-lhes	dar-lhes
dará	dara
dava-nos	dava-nos
dc-que	dc-que
dcana	dcana
dcclrtiaç	dcclrtiac
dceU	dceu
d’cntre	dcntre
dcrcredito	dcrcredito
dcrt	dcrt
dcspvza	dcspvza
dctbragrido	dctbragrido
>dctsc	dctsc
de-----------	de-----------
de-onslitulção	de-onslitulcao
de-opegou-se	de-opegou-se
debatcl-a	debatcl-a
debel-lar	debel-lar
deciar-çve	deciar-cve
decisivo	decisivo
decrrtns	decrrtns
dedicada	dedicada
defender	defender
deíicto	deiicto
deixio	deixio
de^lel^to	delelto
delicados	delicados
delidos	delidos
dellc	dellc
dellus	dellus
demali	demali
democrática	democratica
demoeratim	demoeratim
demorada	demorada
demri	demri
dendo	dendo
denrimr	denrimr
deploráveis	deploraveis
deposesse	deposesse
deprimentes	deprimentes
deraçao	deracao
deram	deram
deria	deria
deroso	deroso
desconhecida	desconhecida
desembro	desembro
desnecessária	desnecessaria
despwas	despwas
desquiles	desquiles
desra	desra
destea	destea
destri-Jbuições	destri-jbuicoes
destribuidas	destribuidas
desvirtuada	desvirtuada
déte	dete
determino-vos	determino-vos
detinha	detinha
deUcto	deucto
devendo-se	devendo-se
devris	devris
dia-bolleo*	dia-bolleo
diariamente	diariamente
diartomente	diartomente
dido	dido
differcntes	differcntes
diingu	diingu
«dill	dill
diquctra	diquctra
dir-sc-to	dir-sc-to
direi(o	direio
diricentci	diricentci
dirigia-do-ae	dirigia-do-ae
dirigida	dirigida
disao	disao
diser	diser
dispõe	dispoe
disposta	disposta
divcrimmaçjo	divcrimmacjo
diversas	diversas
dividtram-se	dividtram-se
divuas	divuas
dizcr-Iho	dizcr-iho
dizel-rfao	dizel-rfao
dizer-lhe	dizer-lhe
djanaracote	djanaracote
dlasc	dlasc
dli-s*-n*s	dli-s-ns
*d’3lina	dlina
dlrpula	dlrpula
dlr*tor	dlrtor
dlurrlmlrurto	dlurrlmlrurto
dlvlúo	dlvluo
dnco	dnco
dnndo	dnndo
doclara	doclara
docunier	docunier
doente	doente
dolorosas	dolorosas
doloroso	doloroso
dolorosos	dolorosos
donodo	donodo
do%oji	dooji
dótarra	dotarra
dotor-café	dotor-cafe
dprereniaróc»	dprereniaroc
drfe-Trrnad	drfe-trrnad
dr7^ílsõn“	drilson
d#rn>-	drn-
drpoz	drpoz
duaj	duaj
duas	duas
dubo	dubo
dumudo	dumudo
dUnlj	dunlj
duns	duns
duplicada	duplicada
d’uraa	duraa
duranu	duranu
durcira	durcira
duroni	duroni
duronte	duronte
d^ver*^-riamente	dver-riamente
d«verÀ	dvera
dzba-	dzba-
eafé	eafe
ealqia	ealqia
eaml-	eaml-
eapiltil	eapiltil
eatendidas	eatendidas
eatranlfos	eatranlfos
eclos	eclos
e’c>r-po	ecr-po
ecrtos	ecrtos
edicções	ediccoes
editoriaes	editoriaes
èèrfo	eerfo
eernett	eernett
eetaçA*	eetaca
efepois	efepois
efetuada	efetuada
effectual-o	effectual-o
effel-fonnulador	effel-fonnulador
efflcadia	efflcadia
eflectuada	eflectuada
efrito	efrito
efti-cazei	efti-cazei
efTsctuada	eftsctuada
e^galho	egalho
ehtja^cousa	ehtjacousa
éíec	eiec
eierito	eierito
eifnhfo	eifnhfo
eiser-cías	eiser-cias
eiUo	eiuo
eleitorais	eleitorais
ellB	ellb
eloquente	eloquente
emergcncia	emergcncia
emlner	emlner
empobrecida	empobrecida
empolgante	empolgante
enan-	enan-
encia	encia
enconjrado	enconjrado
endxs	endxs
enecodra	enecodra
enganoram-s*	enganoram-s
eníor-c»8o	enior-co
enlre	enlre
en)or	enor
enorme	enorme
enqaanto	enqaanto
enrrupeão	enrrupeao
entravão	entravao
envolvidos	envolvidos
envrrcxdura	envrrcxdura
eon-	eon-
eonlr*	eonlr
eoto	eoto
èouelM	eouelm
epocha	epocha
epurada‘e	epuradae
equili-brando-se	equili-brando-se
equiparam-se	equiparam-se
erde	erde
eriá	eria
eríttao	erittao
éroa	eroa
&eróld0	erold
erradamente	erradamente
ertC	ertc
es-crevcr-lhe	es-crevcr-lhe
esbanjá-lo	esbanja-lo
esclarecida	esclarecida
escrupulosas	escrupulosas
es>encial	esencial
e^seneú	eseneu
|eseon	eseon
esfarrapados	esfarrapados
esfor-jro	esfor-jro
esjivera	esjivera
eslejão	eslejao
eslomachico	eslomachico
esmnc&es	esmnces
esoerte	esoerte
espccic	espccic
espe-	espe-
especial	especial
especial-	especial-
especuladores	especuladores
espee	espee
esperançai	esperancai
esphacelada	esphacelada
espúrio	espurio
estabelecí-mento	estabeleci-mento
éstç	estc
este-mngo	este-mngo
estomacaes	estomacaes
estomogos	estomogos
estorna-	estorna-
etc	etc
eterno	eterno
e$tev«	etev
etirjo	etirjo
etriltoada	etriltoada
e^uMlrAo	eumlrao
euphemis-mos	euphemis-mos
ex-Píoçáo	ex-piocao
exatamento	exatamento
excitados	excitados
exclusivas	exclusivas
excu-sart»m-*se	excu-sartm-se
exemplo—Gallilco	exemplogallilco
exerv^do	exervdo
exnortar	exnortar
exn*rlcncto	exnrlcncto
expressiva	expressiva
exprimiu	exprimiu
extlnguir-se*	extlnguir-se
extrahido	extrahido
fabuloso	fabuloso
faça-lhe	faca-lhe
f*adn	fadn
faih	faih
failánd	failand
famosas	famosas
famoso	famoso
fará	fara
fara	fara
farmacêutica	farmaceutica
fatal	fatal
fatcbl	fatcbl
favorave)	favorave
fazer-lhe	fazer-lhe
fcilhur	fcilhur
fCondutAo	fcondutao
fcwomrno	fcwomrno
feffer-9	feffer-
feitamente	feitamente
fficio	fficio
fido	fido
final	final
findo	findo
fiode	fiode
fiqui	fiqui
firm<	firm
firmados	firmados
fiscahxváo	fiscahxvao
fixado	fixado
fjrnow	fjrnow
fknmrdíno	fknmrdino
fksilnou	fksilnou
flarian<>	flarian
fleação	fleacao
flrmar	flrmar
fomar	fomar
forçn	forcn
forem	forem
foriíficnnte	foriificnnte
form	form
forma-	forma-
foxMm	foxmm
fracas	fracas
fran-cez—com	fran-cezcom
franert	franert
frAo	frao
fraterrudíiJe	fraterrudiije
frc/r-	frcr-
frio	frio
f*rmns	frmns
frogo	frogo
frsal	frsal
ftesta	ftesta
ftguns	ftguns
ftodor	ftodor
ftoM1	ftom
fui3d	fuid
funcçôes	funccoes
fuuccionar	fuuccionar
fuzer	fuzer
gasbr	gasbr
gativas	gativas
geate	geate
gerab	gerab
gerai-namente	gerai-namente
gernçáo	gerncao
glo-■ou	glo-ou
gMATEMATICA	gmatematica
gmte	gmte
gnutaf	gnutaf
goáor	goaor
goevemo	goevemo
grand*	grand
grando	grando
grangcla	grangcla
grati-|	grati-
gratifiraçfto	gratifiracfto
gratitlcaçao	gratitlcacao
gravíssima	gravissima
gricultor	gricultor
guncia	guncia
**gundo	gundo
gunta	gunta
guraráo	gurarao
habitantes	habitantes
haver	haver
haverá	havera
hbra	hbra
henderem	henderem
hi>)Am	hiam
hk-cio	hk-cio
^hnaílKçíio	hnailkciio
hnmcna	hnmcna
hnnrà	hnnra
hnroa	hnroa
ho-micidrô	ho-micidro
hodierna	hodierna
homi-cidio/más	homi-cidiomas
hork	hork
horn	horn
horríveis	horriveis
horrivelmente	horrivelmente
houve	houve
hranfa	hranfa
•htrcvbta	htrcvbta
hu-rnühaçúo	hu-rnuhacuo
humanidaae	humanidaae
i-ixiitin	i-ixiitin
í-nto	i-nto
i-to	i-to
iaria	iaria
>i»bcr	ibcr
ic-se	ic-se
(içado	icado
ichapojos	ichapojos
iciencia	iciencia
icío	icio
içlo	iclo
icnriquo	icnriquo
iConcluso	iconcluso
icpoitagcm	icpoitagcm
íctros	ictros
idadâos	idadaos
idadc	idadc
idea	idea
ideato	ideato
identien	identien
ídjunto	idjunto
ieee_-	ieee-
ifil	ifil
ignara	ignara
<igruoame*tq	igruoametq
igualmente	igualmente
iícÃ	iica
iipõí	iipoi
iirni	iirni
iiuml	iiuml
ijgenc	ijgenc
/ijinau	ijinau
ilBCW-	ilbcw-
ilidade	ilidade
ilíou	iliou
*illex	illex
illus-tre	illus-tre
im-pecidq	im-pecidq
imlmonto	imlmonto
immediata	immediata
immediats	immediats
immensidada	immensidada
i*Moaa	imoaa
imoo	imoo
imparcial	imparcial
importância	importancia
importante	importante
impôs	impos
impressionados	impressionados
improòquamente	improoquamente
in-•cdeitavel	in-cdeitavel
in-possivel	in-possivel
inacíitavel	inaciitavel
incom-	incom-
incommodado	incommodado
incomnjoút»	incomnjout
indepe	indepe
índia	india
indic	indic
indicativo	indicativo
indiriduolidaae	indiriduolidaae
indispensável	indispensavel
indo	indo
induitriali-zação	induitriali-zacao
industna	industna
industrializa-<ão	industrializa-ao
ineficiente	ineficiente
in/elictlam	inelictlam
inelos	inelos
inelusivc	inelusivc
inesm	inesm
ínespera-	inespera-
inevitável	inevitavel
infeliz	infeliz
infellrmcnte	infellrmcnte
inftoa	inftoa
ingleza	ingleza
ínll	inll
innoa	innoa
inoeo	inoeo
inqre	inqre
inquerit)	inquerit
ins-	ins-
inscritos	inscritos
insinuadas	insinuadas
insut^is	insutis
intc	intc
intcreSsea	intcressea
inteiramente	inteiramente
intereMc	interemc
interessea	interessea
interprclá-b	interprcla-b
intestinal	intestinal
intransi-gente	intransi-gente
invbaciimlidaob	invbaciimlidaob
inven-	inven-
invicto	invicto
ioMlha	iomlha
iPontr	ipontr
ipqiicnto	ipqiicnto
*íradri	iradri
iravilhosc	iravilhosc
irtiríTiiitt	irtiritiiitt
ísta	ista
istumacacs	istumacacs
itastos	itastos
itnlcza	itnlcza
itrento	itrento
«ituto	ituto
iucomncodos	iucomncodos
íufcHpeaeto	iufchpeaeto
íuidsd	iuidsd
íu^ir	iuir
iuui	iuui
iüuIv	iuuiv
ividadc-	ividadc-
iwntonhA<	iwntonha
iwr-g	iwr-g
ixmtos	ixmtos
ixotoda	ixotoda
(iyspepsias	iyspepsias
izad	izad
jaotidade	jaotidade
jaxiiro	jaxiiro
jgnto	jgnto
jicas	jicas
jiufiçu	jiuficu
jnlrr	jnlrr
jnvjc(0	jnvjc
jomados	jomados
j$ooo	jooo
jornad	jornad
joro	joro
jpbre	jpbre
jptçlligentg^que	jptclligentgque
jr--	jr--
jtblí-ça	jtbli-ca
juato	juato
judicial	judicial
juHrfdA	juhrfda
julgava-se	julgava-se
junsdiçção	junsdiccao
jus-	jus-
jwrtanci»	jwrtanci
klra	klra
krSLE	krsle
laíogo	laiogo
l*a<<na>	lana
langtfida-mer	langtfida-mer
laniera»-	laniera-
lAnn	lann
latogo	latogo
«$lBronehí-t«i	lbronehi-ti
ldict<«	ldict
<ldM-	ldm-
leader	leader
leclarar	leclarar
legae	legae
lei-	lei-
leia	leia
lendana	lendana
lendo	lendo
leneMe	leneme
lentos	lentos
leorleos	leorleos
ler-Munlcipal	ler-munlcipal
les-	les-
lhanezn	lhanezn
lhe-souraria	lhe-souraria
lhesouraria	lhesouraria
libejdadv	libejdadv
licenciadas	licenciadas
licyr	licyr
liebol	liebol
lígá-lo	liga-lo
liistilu	liistilu
lilsto-rt<-n<	lilsto-rt-n
limbolis-tax	limbolis-tax
littera-rio	littera-rio
líuatdade	liuatdade
livram	livram
livre	livre
livrem	livrem
llbertaçáo	llbertacao
llllor	llllor
lllm	lllm
lllu-tre	lllu-tre
l‘lrn<c	llrnc
ln*‘Hulram	lnhulram
ln<™M»i»vel	lnmivel
lo-drifr	lo-drifr
locaes	locaes
lodoe	lodoe
lolcnsamen	lolcnsamen
loltío	loltio
lomallsta	lomallsta
lOOSOUO	loosouo
lorwyn	lorwyn
lovolunlarla	lovolunlarla
lr»b»)ho	lrbho
lRrai	lrrai
lsrmou	lsrmou
l«tn-brei-mc	ltn-brei-mc
lui-	lui-
lunldade	lunldade
luta-	luta-
luti	luti
luvrlrr	luvrlrr
m-rOtMInos	m-rotminos
manifestava-se	manifestava-se
mantendo	mantendo
manteve-se	manteve-se
mar-radb	mar-radb
maravilhosas	maravilhosas
margr	margr
matar-se	matar-se
**mbora	mbora
me-u-	me-u-
meadipos	meadipos
medie	medie
medíétime	medietime
melancólica	melancolica
mentora	mentora
mesflo	mesflo
mesnio	mesnio
mesquinheo	mesquinheo
mestos	mestos
mi-inha	mi-inha
mijitar	mijitar
milagroso	milagroso
milhfct	milhfct
militon-tc	militon-tc
minh-a	minh-a
minrfro	minrfro
misteriosa	misteriosa
mitei	mitei
mllrando	mllrando
mlnensc	mlnensc
mlnlmo	mlnlmo
mmllA	mmlla
mMXM	mmxm
mnci/io	mnciio
mnde	mnde
mngistr	mngistr
mnitoa	mnitoa
mo-lestrio	mo-lestrio
mo-ral	mo-ral
mo-realizadcr	mo-realizadcr
mocracia	mocracia
modcrr»s	modcrrs
moiea	moiea
moleatíos	moleatios
mom^mlo	mommlo
monarchista	monarchista
montanhéa	montanhea
montcvc-sc	montcvc-sc
morie	morie
moro-curiim	moro-curiim
morUs”	morus
moturl	moturl
mpírecln-	mpirecln-
mpre	mpre
<(mpr/no	mprno
m«Qda	mqda
mrompIMO*	mrompimo
m^ses	mses
msItUram	msituram
mtrmucv	mtrmucv
muguet	muguet
muitb	muitb
muitissimó	muitissimo
muitíssimo	muitissimo
múltiplas	multiplas
mulUs	mulus
munleL	munlel
mural	mural
—muumi	muumi
mysteriosos	mysteriosos
n<»-dicamentoi	n-dicamentoi
naçlo	naclo
não—existência	naoexistencia
nâo*seriào	naoseriao
nar-rtram	nar-rtram
nasce	nasce
nasceu	nasceu
nâ>’se	nase
natu-	natu-
na(uzeiw’	nauzeiw
nã^v^le	navle
nccm’	nccm
nccurrenlc	nccurrenlc
ncon-	ncon-
ncqueniM	ncquenim
ne-Io	ne-io
neero	neero
nefico	nefico
neiro	neiro
neita	neita
néjii	nejii
nemhum	nemhum
nezro	nezro
nfco	nfco
nfenor	nfenor
nfio	nfio
nfto	nfto
nheiro	nheiro
niliano	niliano
nlguma	nlguma
n«n-tlngencio	nn-tlngencio
nnlco	nnlco
nnlos”	nnlos
no-vos	no-vos
noém	noem
noiavol	noiavol
nois	nois
nono	nono
noszu	noszu
notável	notavel
novamente	novamente
nov^b^	novb
npenos	npenos
npi«cntou	npicntou
npplicar	npplicar
nprrndiMK^m	nprrndimkm
nrat»	nrat
nrcira	nrcira
nreci	nreci
nrics	nrics
*nrLv>	nrlv
“nrnm-nas	nrnm-nas
«nroító	nroito
n^sta	nsta
nsuita	nsuita
nTirme	ntirme
••ntl^cn^	ntlcn
ntltu-d*s	ntltu-ds
ntoi	ntoi
nuar	nuar
nuense	nuense
nuirr»	nuirr
nutncnlo	nutncnlo
nuutru	nuutru
nvnorarme	nvnorarme
nw’rrr	nwrrr
nxecuçío	nxecucio
o-per^çõ^s	o-percos
oAMiNAH	oaminah
oara	oara
oblíquos	obliquos
obngado	obngado
|>obrc	obrc
obter	obter
|obti	obti
obtido	obtido
occa-sião	occa-siao
ocesso	ocesso
*odal	odal
oDialmláaée	odialmlaaee
oêln	oeln
oErBXDS»	oerbxds
of-rteio	of-rteio
oferta-do	oferta-do
offereceu-me	offereceu-me
ofiLtear	ofiltear
ofTerece]	ofterece
)ogar	ogar
o/idc	oidc
oíficina	oificina
oificio	oificio
*oii-xaxw	oii-xaxw
okes	okes
olhnf	olhnf
olunoè	olunoe
omcn-te	omcn-te
ònícamente	onicamente
<oníro	oniro
onje	onje
onte	onte
onuais	onuais
onüu	onuu
ooiníãn	ooinian
oois	oois
oor/*ue	oorue
oossam	oossam
op-pnrelho	op-pnrelho
opin	opin
opor-se	opor-se
opulentissima	opulentissima
orgo-dc	orgo-dc
oridade	oridade
orleoUcão	orleoucao
ormcs	ormcs
orovideooas	orovideooas
os-de	os-de
osta	osta
osxurIo	osxurio
o\tarinheiro	otarinheiro
ou-l^tudontct	ou-ltudontct
óungu	oungu
ourcra	ourcra
ousados	ousados
outre	outre
ouvío	ouvio
p)-der	p-der
p-rmittião	p-rmittiao
p<-sor	p-sor
pa-dendo	pa-dendo
pagarão	pagarao
paguui)	paguui
paixães	paixaes
panda»	panda
par-	par-
para-guaycnsis-	para-guaycnsis-
paraibano	paraibano
paraquxiieias	paraquxiieias
pari	pari
parq	parq
parti^ario	partiario
partna)	partna
paru	paru
pasmando	pasmando
passível	passivel
patundu	patundu
pauinuo	pauinuo
paulistana	paulistana
paulUtas	paulutas
paxaí	paxai
pccllho	pccllho
“pcg>J“	pcgj
pcifl	pcifl
pcocurar	pcocurar
pcratdu»	pcratdu
pcrsunjJo	pcrsunjjo
peçuoria	pecuoria
pederaso	pederaso
pederosas	pederosas
pefo	pefo
penhum	penhum
penosos	penosos
per-	per-
perdendo	perdendo
perdi-QUARTA	perdi-quarta
perfeitamente	perfeitamente
perma-nentea	perma-nentea
permancnW	permancnw
permanoncla	permanoncla
•peroao	peroao
pertencentes	pertencentes
pes-sôa	pes-soa
petooa	petooa
pezo	pezo
pharmaceuticu	pharmaceuticu
pi	pi
p&itiífos	pitiifos
pjxa	pjxa
plena	plena
pleno	pleno
pllôto	plloto
plMOPOS	plmopos
pnliti-co	pnliti-co
pnncipalmcntç	pnncipalmcntc
pnr-tic^r	pnr-ticr
pnra	pnra
pnvpriaj	pnvpriaj
po-a	po-a
po-úção	po-ucao
poalçáo	poalcao
po>alvt|	poalvt
poderá	podera
poderem	poderem
podería	poderia
poderíam	poderiam
poderosa	poderosa
poderoso	poderoso
podia	podia
pod*rA	podra
põem	poem
poiu	poiu
polaco-	polaco-
politiea	politiea
políUçn	poliucn
polto	polto
ponha	ponha
popula-	popula-
poraue	poraue
porln-vox	porln-vox
poroue	poroue
portado-res	portado-res
portaito	portaito
pos-o	pos-o
posso	posso
pouc	pouc
pouena	pouena
povu	povu
pparelho	pparelho
«ppruvAçflo	ppruvacflo
praclM)	praclm
pramorra	pramorra
prandes	prandes
prandr	prandr
prarrmrtdo	prarrmrtdo
pratica-mente	pratica-mente
p’rcc*	prcc
prcci-1	prcci-
pre-	pre-
pre-fabricado	pre-fabricado
preatlglou	preatlglou
preci-acabar	preci-acabar
precisa-mente	precisa-mente
precLumente	preclumente
predominante	predominante
premlo	premlo
prendei*a	prendeia
prender	prender
prenderem	prenderem
prepotentes	prepotentes
prescrtifand^	prescrtifand
presenteo	presenteo
prestadas	prestadas
prestdontci	prestdontci
previstos	previstos
p*rfumes	prfumes
pricipalmtute	pricipalmtute
primeiraiuenle	primeiraiuenle
principelmente	principelmente
prirtcipe	prirtcipe
privifcpta-	privifcpta-
prlmdra	prlmdra
prlnclpalmcn-<c	prlnclpalmcn-c
pro-	pro-
pro-onnharo	pro-onnharo
proce	proce
proCodimen-tocriminal	procodimen-tocriminal
prodigiosa	prodigiosa
prodigioso	prodigioso
profética	profetica
proflMlooal»	proflmlooal
proícsroK-	proicsrok-
proitarf	proitarf
pro^Jerem	projerem
prome	prome
promoioria	promoioria
prompta	prompta
propalada	propalada
proprlo	proprlo
proríncío	prorincio
prostrar-se	prostrar-se
protcxrio	protcxrio
provadas	provadas
>prov®dw	provdw
proví	provi
provincial	provincial
provincta	provincta
proxlmo»	proxlmo
proxlmo	proxlmo
prtços	prtcos
prtt-tlgio	prtt-tlgio
prxa	prxa
psiragens	psiragens
psra	psra
psrte	psrte
pstomacues	pstomacues
psubria	psubria
ptcuapta	ptcuapta
ptlc	ptlc
ptra	ptra
pubheiçlo	pubheiclo
publicados	publicados
pura	pura
purga-tivá$>	purga-tiva
purga-tiyns	purga-tiyns
purgativas	purgativas
pxwe	pxwe
qieema-tal-ost	qieema-tal-ost
qntar	qntar
qonsta	qonsta
qrrr	qrrr
qtfe	qtfe
qualiilpaçio	qualiilpacio
qualqeur	qualqeur
quaM	quam
quand	quand
quarta-fei	quarta-fei
quasi	quasi
queglão	queglao
quererá	querera
querr	querr
quidro	quidro
quisêramos	quiseramos
qu^mndas	qumndas
quMrn	qumrn
qunntj	qunntj
quolkjode	quolkjode
qut-r	qut-r
quun-toyos	quun-toyos
quxdra	quxdra
r-ão	r-ao
r-do	r-do
r-Ja	r-ja
r-ueronea	r-ueronea
r^aBur	rabur
racanú	racanu
raciojiiiio	raciojiiiio
radicalrrente	radicalrrente
radiculmente	radiculmente
radlflliitn	radlflliitn
radto	radto
raesm	raesm
‘rakalh*>	rakalh
rapkfo	rapkfo
rarão	rarao
rasão	rasao
rasoavel	rasoavel
<*0>ratnl	ratnl
ratre	ratre
ra^un	raun
rcaenA	rcaena
rcallotr-se	rcallotr-se
rccebêra	rccebera
rcCebidi	rccebidi
rccompcruado	rccompcruado
rcconhccimcnto	rcconhccimcnto
rccor	rccor
rcdobrarA	rcdobrara
rciÀi	rciai
rclompaflo	rclompaflo
rcluctancia	rcluctancia
rcspirniono	rcspirniono
re-mottido	re-mottido
re-ponsavel	re-ponsavel
rea)idade	reaidade
realébolecimeoto	realebolecimeoto
realíz*	realiz
realiza-	realiza-
reallundo	reallundo
realm	realm
realmen-te	realmen-te
realmente	realmente
realrnente	realrnente
reaolvi	reaolvi
reap*-	reap-
rebelde	rebelde
reciamudaa	reciamudaa
recomu	recomu
reconhecida	reconhecida
reconhecidos	reconhecidos
recorreir	recorreir
recuoeracão	recuoeracao
recusar-me	recusar-me
reder	reder
referida	referida
referidas	referidas
referiu-se	referiu-se
refindo	refindo
refn	refn
regl^nalUmo	reglnalumo
relatoru)	relatoru
relnlcbrào	relnlcbrao
relra	relra
rempre	rempre
remunerada	remunerada
repetidas	repetidas
requeridas	requeridas
rerdace	rerdace
rerteme	rerteme
res-	res-
res-nnnsabílldades	res-nnnsabilldades
residern	residern
resoeito	resoeito
resolve	resolve
resolví	resolvi
respanMblIldjdcs	respanmblildjdcs
respecjvos/x/íwj	respecjvosxiwj
respectivos	respectivos
respei-Ct	respei-ct
respiratório	respiratorio
restabelecida	restabelecida
resteas	resteas
restinho	restinho
resultndo	resultndo
rêtiecte	retiecte
retlfn	retlfn
rettstlr	rettstlr
reunidos	reunidos
rexullado»	rexullado
rexultado*	rexultado
rgnís-mos	rgnis-mos
riaco	riaco
riãilicção	riailiccao
riamenqo	riamenqo
rida	rida
riencta	riencta
rífk<n*>	rifkn
rígido	rigido
rigorimo	rigorimo
rigorora	rigorora
rigorosíssimo	rigorosissimo
rílldãd	rilldad
rindo	rindo
rioile	rioile
rítnlco	ritnlco
riuuw	riuuw
rivi	rivi
rkos	rkos
rl«n‘«‘e	rlne
»rlnTnr‘	rlntnr
rlom	rlom
rmcrgOnciM	rmcrgoncim
rnen-dicancia	rnen-dicancia
rnenulmeM*	rnenulmem
rnm^reío	rnmreio
rntfo	rntfo
roaliuda	roaliuda
robusto	robusto
rodoviária	rodoviaria
rorraU	rorrau
rospoid^á	rospoida
roUron	rouron
«rpilulas	rpilulas
rrce	rrce
rrecuo	rrecuo
rrfimuiençfio	rrfimuiencfio
rrin	rrin
rrio	rrio
r*rnovrto	rrnovrto
«rroçancM	rrocancm
rroUwr	rrouwr
rrwres	rrwres
rtKdrnu	rtkdrnu
rtqurza*	rtqurza
rtrmar	rtrmar
rttof	rttof
rtttrra	rtttrra
rubro	rubro
rude	rude
rvircira	rvircira
r^ypHlo	ryphlo
s-bullul	s-bullul
sabe	sabe
saber-sa	saber-sa
sai-bão	sai-bao
saiba	saiba
sal\*açlo	salaclo
salu-bre	salu-bre
salvar	salvar
salvará	salvara
sámpaüas	sampauas
sanpre	sanpre
saspeitas	saspeitas
satis-fuctorio	satis-fuctorio
sc-enêia	sc-eneia
scena	scena
scienci»	scienci
scindiram-se	scindiram-se
scomo	scomo
scrios	scrios
scrt>	scrt
scrura-listas	scrura-listas
scui	scui
selbar	selbar
sendo-Iho	sendo-iho
sendo-lhe	sendo-lhe
senjo	senjo
sensacional	sensacional
septenato	septenato
serem	serem
serl	serl
serpre	serpre
sert	sert
seruX	serux
servisse	servisse
sfffpcil	sfffpcil
sido	sido
sígredo	sigredo
siitema	siitema
sinccro	sinccro
sinceras	sinceras
sinceros	sinceros
»s$ionano	sionano
siquer	siquer
sJugvu	sjugvu
slão	slao
slderlid*	slderlid
slstenütíra-	slstenutira-
^snita	snita
so-menu-	so-menu-
sobic	sobic
socinlogo	socinlogo
»sõcs	socs
sóffrç	soffrc
sôffrenJo	soffrenjo
sofrtr	sofrtr
soiTta	soitta
solibtudu	solibtudu
soluç	soluc
somos	somos
soorcludo	soorcludo
srounda	srounda
•stomacaes	stomacaes
sua’cogitação	suacogitacao
suavisasse-Ihe	suavisasse-ihe
subscrevo-	subscrevo-
subversivo	subversivo
*su«cidou-se	sucidou-se
sufrario	sufrario
suicidar-se	suicidar-se
sujo	sujo
sunlo	sunlo
suppoodo	suppoodo
suppra	suppra
svihUndá	svihunda
tabclecido	tabclecido
tadml	tadml
tadoal	tadoal
tam-i	tam-i
tamogag	tamogag
tario	tario
tçndo	tcndo
tcrra	tcrra
tcsiemunhu	tcsiemunhu
tcsulbdor-t	tcsulbdor-t
tdra	tdra
teem	teem
teenteo	teenteo
teis	teis
tel-o	tel-o
telegr	telegr
tem-io	tem-io
tempe	tempe
ten-tavi	ten-tavi
tenha	tenha
tenho	tenho
teni	teni
teohaes	teohaes
teps-ratUnio	teps-ratunio
terá	tera
terào	terao
terço	terco
tereis	tereis
terem	terem
teriam	teriam
termoa	termoa
terrô	terro
testemu-nta	testemu-nta
teve	teve
tevô	tevo
tfto	tfto
ticular	ticular
tí*dot	tidot
tima	tima
timbem	timbem
tinham	tinham
tintos	tintos
tíotalugo	tiotalugo
titeratura	titeratura
tive	tive
tivera	tivera
tivesse	tivesse
tizar	tizar
tLtiiu	tltiiu
tlvuda	tlvuda
tm-bèbe	tm-bebe
tmaginaçáo	tmaginacao
«tnitura	tnitura
tnréttoà	tnrettoa
toch	toch
<tod-dirmos	tod-dirmos
tol-i	tol-i
»tolk	tolk
tomacaei	tomacaei
tomo-se	tomo-se
tornnu-so	tornnu-so
|tORrc*	torrc
total-m*nte	total-mnte
to*Tr	totr
tounfn	tounfn
tpcGe	tpcge
traas-loroar-se	traas-loroar-se
tragão	tragao
tramfertdo	tramfertdo
tramiferido	tramiferido
transfrrU	transfrru
transpor-1	transpor-
transportando-vòs	transportando-vos
transportar-se	transportar-se
trarnadn	trarnadn
trax*r	traxr
trazem	trazem
triclor	triclor
trimes-treVTís	trimes-trevtis
trisfe	trisfe
triumphos	triumphos
triun	triun
trlguom	trlguom
trorueu»-te	trorueu-te
trús	trus
t«rzr	trzr
tscr\wr\o	tscrwro
*t<tema	ttema
ttMOMntN	ttmomntn
ttvMoi	ttvmoi
tuprerno	tuprerno
tUpúbllra	tupubllra
tuqutin	tuqutin
twi|ur	twiur
u-soóie	u-sooie
<u-zzaodc	u-zzaodc
ucrson	ucrson
uftirmoú	uftirmou
uhtmn	uhtmn
uídMe	uidme
uiiíis	uiiiis
uioa	uioa
ul-tenor	ul-tenor
ul-Um»	ul-um
1»ulnifnmCo	ulnifnmco
u<lonal	ulonal
ultimamtnto	ultimamtnto
ultl-	ultl-
ultrages	ultrages
(un-ckmarfos	un-ckmarfos
«ünicn	unicn
unti-ca-tharracR	unti-ca-tharracr
unvt	unvt
uo^u-	uou-
up>ui>	upui
urau	urau
urosv	urosv
urrrr	urrrr
uttl	uttl
uuica	uuica
uzar	uzar
uzndos	uzndos
va^ar	vaar
vaie-	vaie-
valcria	valcria
vale-	vale-
vale-tudo	vale-tudo
vale—não	valenao
valería	valeria
vcncibllldadc	vcncibllldadc
vcntrl	vcntrl
vcoda	vcoda
vè-sc	ve-sc
véem	veem
venha	venha
venho	venho
vera	vera
verdad	verdad
verdadeira	verdadeira
veremos	veremos
vezex	vezex
vi^ào	viao
vidindo-se	vidindo-se
viikA	viika
vImh	vimh
vimos	vimos
vinte	vinte
viria	viria
vlte	vlte
vndo	vndo
voadas	voadas
volorizor	volorizor
vôluntapjrtll	voluntapjrtll
voot	voot
vrSo	vrso
vttória	vttoria
vulgarisada	vulgarisada
vultoso*	vultoso
vuuw	vuuw
watureze	watureze
wfôra	wfora
wlro	wlro
wnsav*‘s	wnsavs
wrUt‘W	wrutw
wuégué-	wuegue-
«x-cuidtraU	x-cuidtrau
£x-Interno	x-interno
xenuclonal	xenuclonal
xlmo	xlmo
xMsessorlas	xmsessorlas
«xpecUtUva	xpecutuva
xvslm	xvslm
yeJmcnte	yejmcnte
yoílufll	yoilufll
zeloso	zeloso
zendo	zendo
