-corrido	-corrido
-Exf-«per	-exf-per
-vicção	-viccao
aahio	aahio
accu-np	accu-np
acicncia	acicncia
aconteça	aconteca
(acto	acto
acto	acto
ad-mittida	ad-mittida
agi-tão	agi-tao
aífirma	aifirma
analphabetos	analphabetos
andarão	andarao
anjiu	anjiu
aojào	aojao
arrúmem-se	arrumem-se
artig)	artig
artirmativa	artirmativa
assignadas	assignadas
atfirmar	atfirmar
athrmou	athrmou
atiypóihtse	atiypoihtse
aubtdo	aubtdo
ba-»e	ba-e
ba-r	ba-r
bCiios	bciios
bisU»sem	bisusem
caraclcrisado	caraclcrisado
cbügaria	cbugaria
çcla	ccla
ccnjectu-ras	ccnjectu-ras
cffeito	cffeito
chi-méras	chi-meras
civilisado	civilisado
çnhprnr	cnhprnr
coiiulia	coiiulia
collaboradores	collaboradores
con-du/ir	con-duir
con-trarit)	con-trarit
conh	conh
considertt	considertt
considoraçõ	considoraco
consjatação	consjatacao
consultadoa	consultadoa
consultavão	consultavao
coQsuha	coqsuha
corbiTíf^Wborato	corbitifwborato
corpo-	corpo-
correspondeneia	correspondeneia
ç^stas	cstas
dará	dara
d’cntre	dcntre
deíicto	deiicto
deixio	deixio
de^lel^to	delelto
delidos	delidos
deposesse	deposesse
deram	deram
destri-Jbuições	destri-jbuicoes
destribuidas	destribuidas
deUcto	deucto
dirigida	dirigida
diser	diser
dividtram-se	dividtram-se
dizel-rfao	dizel-rfao
*d’3lina	dlina
doente	doente
duas	duas
eatranlfos	eatranlfos
e’c>r-po	ecr-po
edicções	ediccoes
editoriaes	editoriaes
èèrfo	eerfo
ehtja^cousa	ehtjacousa
empobrecida	empobrecida
enconjrado	enconjrado
entravão	entravao
equiparam-se	equiparam-se
erde	erde
es>encial	esencial
esjivera	esjivera
esphacelada	esphacelada
espúrio	espurio
euphemis-mos	euphemis-mos
excu-sart»m-*se	excu-sartm-se
exemplo—Gallilco	exemplogallilco
faih	faih
failánd	failand
fara	fara
fará	fara
feffer-9	feffer-
feitamente	feitamente
fido	fido
fiode	fiode
flrmar	flrmar
forem	forem
form	form
fran-cez—com	fran-cezcom
fui3d	fuid
fuzer	fuzer
geate	geate
glo-■ou	glo-ou
goáor	goaor
gunta	gunta
haverá	havera
^hnaílKçíio	hnailkciio
hnnrà	hnnra
ho-micidrô	ho-micidro
hodierna	hodierna
homi-cidio/más	homi-cidiomas
houve	houve
içlo	iclo
idea	idea
ignara	ignara
iipõí	iipoi
ilíou	iliou
immediata	immediata
indepe	indepe
indicativo	indicativo
ingleza	ingleza
insinuadas	insinuadas
interessea	interessea
intransi-gente	intransi-gente
ipqiicnto	ipqiicnto
jomados	jomados
j$ooo	jooo
jptçlligentg^que	jptclligentgque
jr--	jr--
jtblí-ça	jtbli-ca
judicial	judicial
«$lBronehí-t«i	lbronehi-ti
ldict<«	ldict
lei-	lei-
libejdadv	libejdadv
licyr	licyr
littera-rio	littera-rio
medie	medie
mesflo	mesflo
mmllA	mmlla
mnci/io	mnciio
moleatíos	moleatios
monarchista	monarchista
morie	morie
moro-curiim	moro-curiim
muitissimó	muitissimo
muitíssimo	muitissimo
não—existência	naoexistencia
nâo*seriào	naoseriao
nasce	nasce
nâ>’se	nase
nã^v^le	navle
nccurrenlc	nccurrenlc
néjii	nejii
niliano	niliano
noém	noem
noiavol	noiavol
nsuita	nsuita
of-rteio	of-rteio
oferta-do	oferta-do
oíficina	oificina
op-pnrelho	op-pnrelho
opin	opin
ousados	ousados
ouvío	ouvio
pagarão	pagarao
pefo	pefo
penhum	penhum
pes-sôa	pes-soa
p&itiífos	pitiifos
plena	plena
plMOPOS	plmopos
poderem	poderem
põem	poem
povu	povu
«ppruvAçflo	ppruvacflo
prirtcipe	prirtcipe
proce	proce
psrte	psrte
publicados	publicados
qualiilpaçio	qualiilpacio
quand	quand
queglão	queglao
quererá	querera
quisêramos	quiseramos
raciojiiiio	raciojiiiio
rasão	rasao
ra^un	raun
re-ponsavel	re-ponsavel
recorreir	recorreir
respiratório	respiratorio
resteas	resteas
rêtiecte	retiecte
rospoid^á	rospoida
rtrmar	rtrmar
sai-bão	sai-bao
saspeitas	saspeitas
sc-enêia	sc-eneia
scena	scena
scienci»	scienci
scindiram-se	scindiram-se
sendo-Iho	sendo-iho
septenato	septenato
sfffpcil	sfffpcil
sido	sido
siquer	siquer
sobic	sobic
somos	somos
sua’cogitação	suacogitacao
*su«cidou-se	sucidou-se
suicidar-se	suicidar-se
suppra	suppra
tario	tario
ten-tavi	ten-tavi
terem	terem
termoa	termoa
testemu-nta	testemu-nta
tivera	tivera
tol-i	tol-i
tragão	tragao
trimes-treVTís	trimes-trevtis
trlguom	trlguom
uftirmoú	uftirmou
ultrages	ultrages
uuica	uuica
valcria	valcria
vale—não	valenao
valería	valeria
vinte	vinte
